In the early 2000s, mewonkind's folly led to the breakdown of society and the restructuring of general cultural and technological vector-goals. At some point interest-tribes formed into coherent anarcho-syndicates, creating new economic models which began to isolate themselves in order to maximize survival attributes and minimize unknown variable influences. It was around that time the blast doors went down. Nobody's sure how long exactly; it's been hundreds of season renewals and a ton of spin-offs and crossovers since then though. At least that's what you were taught in data-download segment 2-histori-political info part 27A while syncing the standard edu-packets. Who the hell knows for real though, right?

Whatevs. Feels like just another day in the MASSIVE HIVE KNOWN as CONvergence.

BTW, you sure have made quite the number of enemies.

Today's magic number is 882.

What is your name?

I beg your pardon?

What is your name?

* * *

>look sphere
OOOOoooo glowy-sphere thingie! Its purple soft glow makes you feel safe and secure. It looks like there's some sort of helix-key as a component to the glowy-ness but it's unclear how you would remove it.

>take key
That seems to be a part of the Glowing Sphere.

>take sphere
That's fixed in place.

* * *

>A-Frame! McGullicutty
Oh, A-Frame! McGullicutty eh!? I've heard a you.

Space Lounge
You are in the Space Lounge. It's dim and glowy all over with pulsating colors and subtle hypnotic sounds.

You can see an airlock, a black ninja outfit, a bar (on which are a Glowing Sphere and a glittery box (closed)), a bench, a comfy looking chair, a bartender, AFrame, and a securityBot here.

You can go east through the airlock (closed) and west from here.

>ls
I didn't understand that sentence.

* * *

>A-frame
A-frame!? Aaaah, that's a good one.

Space Lounge
You are in the Space Lounge. It's dim and glowy all over with pulsating colors and subtle hypnotic sounds.

You can see an airlock, a black ninja outfit, a bar (on which are a Glowing Sphere and a glittery box (closed)), a bench, a chair, a bartender, AFrame, and a Security bot here.

You can go east through the airlock (closed) and west from here.

(From here, you can move to east and west.)

>e
(first opening the airlock)
As you enter the Veranda Walkway you see a floating dolphin surveillance pod.
Sweet it seems like your AdBlaster2000 shielded you from detection. 

Veranda Walkway
Outside the Space Lounge you look out into the larger Raditree Building to see the pool under a high ceiling. Consuite lies beyond the pool in the main courtyard. Boffers beat each other up in the fenced in section of the courtyard.

You can see an airlock, a black rod, and a floating dolphin (closed) here.

You can go north, northeast, northwest, southeast, west through the airlock to the Space Lounge, up, and down from here.

(From here, you can move to north, northeast, northwest, southeast, west, up, and down.)

>se
Upper Southside Hallway
This hallway is NUTS - there are signs everywhere and lights and sounds flashing. From this hallway you can get into a bunch of Party Rooms

You can go north, northeast, northwest to the Veranda Walkway, south, southeast, and southwest from here.

(From here, you can move to north, northeast, northwest, south, southeast, and southwest.)

>se
Round1
Welcome to Trivia, I'm your host, a computer program super full of useless information. We have only one rule; please don't cheat - no looking stuff up using centralized data stores. Asking people around you is okay though I suppose.

Questions will be simple this round being worth five points a piece, but will increase value as the game goes on.

Answers must be given with Capitalization and exact spelling.

Wrong answers will not be rewarded with correct answers so get it right! If ya don't like it...cry me a spriver! Once you start the quiz you are trapped within it's quizzy embrace until the end so now is your chance to leave.

This first section is on films involving simulated realities and questionable memories.

Who are you? Are you your memories? Are you what you have done? Are you what you will do? Or are you nothing at all but a wisp...or maybe "just" a program? 

You can go northwest to the Upper Southside Hallway from here.

(From here, you can move to northwest.)

This film has annoying gothy villians but a super cool reveal that everyone was in a giant space habitat the WHOLE TIME?! (btw foreshadowing...)

Please enter your answer

* * *

>AF
AF!? Aaaah, that's a good one.

Space Lounge
You are in the Space Lounge. It's dim and glowy all over with pulsating colors and subtle hypnotic sounds.

You can see an airlock, a black ninja outfit, a bar (on which are a Glowing Sphere and a glittery box (closed)), a bench, a chair, a bartender, AFrame, and a Security bot here.

You can go east through the airlock (closed) and west from here.

(From here, you can move to east and west.)

>e
(first opening the airlock)
As you enter the Veranda Walkway you see a floating dolphin surveillance pod.
Sweet it seems like your DiscoWig shielded you from detection. 

Veranda Walkway
Outside the Space Lounge you look out into the larger Raditree Building to see the pool under a high ceiling. Consuite lies beyond the pool in the main courtyard. Boffers beat each other up in the fenced in section of the courtyard.

You can see an airlock, a black rod, and a floating dolphin (closed) here.

You can go north, northeast, northwest, southeast, west through the airlock to the Space Lounge, up, and down from here.

(From here, you can move to north, northeast, northwest, southeast, west, up, and down.)

>SE
Upper Southside Hallway
This hallway is NUTS - there are signs everywhere and lights and sounds flashing. From this hallway you can get into a bunch of Party Rooms

You can go north, northeast, northwest to the Veranda Walkway, south, southeast, and southwest from here.

(From here, you can move to north, northeast, northwest, south, southeast, and southwest.)

>SE
Round1
Welcome to Trivia, I'm your host, a computer program super full of useless information. We have only one rule; please don't cheat - which means no looking stuff up using centralized data stores. Asking people around you is okay though I suppose.

Questions will be simple this round being worth five points a piece, but will increase in value as the game goes on.

Answers must be given with Capitalization and exact spelling.

Wrong answers will not be rewarded with correct answers - I'm not telling you the right answer. I have ONE singular accepted ABSOLUTELY CORRECT answer it's in a table and it is EXACT and PERFECT - I am the ULTIMATE IMPARTIAL QUIZ JUDGE. If ya don't like it...CRY ME A SPRIVER! OH BTW you are trapped within my quizzy embrace until the end so just accept your fate. Srsly don't try to leave or anything you'll just waste your answer-chances. The quiz is only four rounds of four questions each - just relax you're not stuck in a Quiz Vortex or anything...(I hope...)

-----------

The first section is on films involving simulated realities and questionable memories.

Who are you? Are you your memories? Are you what you have done? Are you what you will do? Or are you nothing at all but a wisp...or maybe "just" a program? 

You can go northwest to the Upper Southside Hallway from here.

(From here, you can move to northwest.)

In which movie did the main character die from super disturbing eye bulging decompression after helmet face plate breakage in the opening scene then but it turned it was just a dream? (or was it a premonition? or was it an implanted memory?)

Please enter your answer

>afds
Incorrect. Next question.

This movie has a sail boat smash into the end of a fake world. Everyone watching just goes totally nuts.

Please enter your answer

>asdf
Incorrect. Next question.

This film has annoying gothy villians but a super cool reveal that everyone was in a giant space habitat the WHOLE TIME?! (btw foreshadowing...)

Please enter your answer

>afds
Incorrect. Next question.

In which film did someone get offered a choice between two pills and then didn't take both of them like they should have?

Please enter your answer

>asdf
That was Round One, now onto Round Two!

Round2
Now onto Round Two where the questions get slightly harder but are worth ten points a piece.

You can see no obvious exits.

(There are no routes out of this room.)

What movie has the Highland Games, a Witch, and Craig Ferguson as Lord Macintosh?

Please enter your answer

>adsf
That was Round Two, now onto Round Three!

Round3
Round Three is here! The questions are harder but now worth fifteen points a piece.

You can see no obvious exits.

(There are no routes out of this room.)

In 1908, what Ford Model was first produced, eventually being named the Car of the Century?

Please enter your answer

>asdf
That was Round Three, now onto Round Four!

Round4
This is it, the final round. You're so close to escaping this quiz that not even a Quiz Vortex could keep you from exiting the quiz-field. The questions are worth twenty points a piece.

This round is about choices, random forces and what they lead to...which is of course PARALLEL UNIVERSES!

Every choice spawned from every individual's mind's eye throughout time and space creating entire universes with every passing moment. The sea of thought embracing the seed of thought; the birth of what-ifs reflecting infinitely. 

You can see no obvious exits.

(There are no routes out of this room.)

Who wrote The Coming of the Quantam Cats, which includes a parallel universe prison planet, and a triad -relationship including three different versions of the same person? (OMG that is so hot! I'd be SO gay for me BTWs)

Please enter your answer

* * *

>AFrame the Exploder
Oh AFrame the Exploder eh!? I've heard a you.

Space Lounge
You are in the Space Lounge. It's dim and glowy all over with pulsating colors and subtle hypnotic sounds.

You can see an airlock, a black ninja outfit, a bar (on which are a Glowing Sphere and a glittery box (closed)), a bench, a chair, a bartender, AFrame, and a securityBot here.

>look bench
Cool smooth bench.

>sit bench
I didn't understand that sentence.

>sit on bench
You get onto the bench.

>look
Space Lounge (on the bench)
You are in the Space Lounge. It's dim and glowy all over with pulsating colors and subtle hypnotic sounds.

You can see an airlock, a black ninja outfit, a bar (on which are a Glowing Sphere and a glittery box (closed)), a chair, a bartender, AFrame, and a securityBot here.

>get off bench
You get off the bench.

Space Lounge
You are in the Space Lounge. It's dim and glowy all over with pulsating colors and subtle hypnotic sounds.

You can see an airlock, a black ninja outfit, a bar (on which are a Glowing Sphere and a glittery box (closed)), a bench, a chair, a bartender, AFrame, and a securityBot here.

>look ninja
(the black ninja outfit)
This is a ninja outfit, it's black and has a hood that covers your face. It has a nice pocket in it to store cool ninja gear. It has these sweet built in booties that muffle your footsteps as if you were a total ninja, which you totally are if you are wearing this outfit. You could sneak around a place with shadows without being detected if you were wearing this thing. You'd be so ninja.

The black ninja outfit's pocket contains a throwing star and a smoke bomb.

>take ninja
(the black ninja outfit)
Taken.

>put on ninja outfit
You are a ninja! It feels like you could blend into the shadows, or maybe you ARE the shadows, this ninja outfit makes you feel super ninja-like

>look
Space Lounge
You are in the Space Lounge. It's dim and glowy all over with pulsating colors and subtle hypnotic sounds.

You can see an airlock, a bar (on which are a Glowing Sphere and a glittery box (closed)), a bench, a chair, a bartender, AFrame, and a securityBot here.

>pick up smoke bomb
Taken.

>pick up ninja star
You can't see any such thing.

>look pocket
The black ninja outfit's pocket is kind of unremarkable, not really exciting like some cool crazy gun would be or something.

In the black ninja outfit's pocket is a throwing star.

>inventory
You're carrying a smoke bomb, a message receiver, a coin, and a dagger. You're wearing a black ninja outfit and ElectroMisdirector.

>look electromisdirector
A small device shaped like a horseshoe worn as a hat that misdirects any light coming towards your face upward. Kinda makes it look like you have no head. Totally legal (as long as you have the licensure information correctly processed of course). (Which you don't.)

>points
I didn't understand that sentence.

>look dagger
The dagger is kind of unremarkable, not really exciting like some cool crazy gun would be or something.

* * *

>ASDF
ASDF? Interesting, nice.

Space Lounge
You are in the Space Lounge. It's dim and glowy all over with pulsating colors and subtle hypnotic sounds.

You can see an airlock, a black ninja outfit, a bar (on which are a Glowing Sphere and a glittery box (closed)), a bench, a chair, a bartender, AFrame, and a Security bot here.

You can go east through the airlock (closed) and west from here.

(From here, you can move to east and west.)

>e
(first opening the airlock)
As you enter the Veranda Walkway you see a floating dolphin surveillance pod.
Sweet it seems like your ElectroMisdirector shielded you from detection. 

Veranda Walkway
Outside the Space Lounge you look out into the larger Raditree Building to see the pool under a high ceiling. Consuite lies beyond the pool in the main courtyard. Boffers beat each other up in the fenced in section of the courtyard.

You can see an airlock, a black rod, and a floating dolphin (closed) here.

You can go north, northeast, northwest, southeast, west through the airlock to the Space Lounge, up, and down from here.

(From here, you can move to north, northeast, northwest, southeast, west, up, and down.)

>se
Upper Southside Hallway
This hallway is NUTS - there are signs everywhere and lights and sounds flashing. From this hallway you can get into a bunch of Party Rooms

You can go north, northeast, northwest to the Veranda Walkway, south, southeast, and southwest from here.

(From here, you can move to north, northeast, northwest, south, southeast, and southwest.)

>se
Round1
Welcome to Trivia, I'm your host, a computer program super full of useless information. We have only one rule; please don't cheat - which means no looking stuff up using centralized data stores. Asking people around you is okay though I suppose.

Questions will be simple this round being worth five points a piece, but will increase in value as the game goes on.

Answers must be given with Capitalization and exact spelling.

Wrong answers will not be rewarded with correct answers - I'm not telling you the right answer. I have ONE singular accepted ABSOLUTELY CORRECT answer - I am the ULTIMATE IMPARTIAL QUIZ JUDGE. If ya don't like it..CRY ME A SPRIVER! Once you start the quiz you are trapped within it's quizzy embrace until the end so now is your chance to leave. Go on - git! COWARDS...

This first section is on films involving simulated realities and questionable memories.

Who are you? Are you your memories? Are you what you have done? Are you what you will do? Or are you nothing at all but a wisp...or maybe "just" a program? 

You can go northwest to the Upper Southside Hallway from here.

(From here, you can move to northwest.)

This movie has a sail boat smash into the end of a fake world. Everyone watching just goes totally nuts.

Please enter your answer

* * *

>Aaaaaaaron
Hi, Aaaaaaaron!

Splounge-Dystopia
Watch your back, and don't let the cams spy your face. by Aaron Prust
Release 1 / Serial number 180219 / Inform 7 build 6M62 (I6/v6.33 lib 6/12N) SD
Oh Aaaaaaaron eh!? I've heard a you.
Space Lounge
You are in the Space Lounge. It's dim and glowy all over with pulsating colors and subtle hypnotic sounds.

You can see an airlock, a black ninja outfit, a bar (on which are a Glowing Sphere and a glittery box (closed)), a bench, a chair, a bartender, AFrame, and a Security bot here.

You can go east through the airlock (closed) from here.

(From here, you can move to east.)

* * *

>Aaron
Aaron? Interesting, nice.

Space Lounge
You are in the Space Lounge. It's dim and glowy all over with pulsating colors and subtle hypnotic sounds.

You can see an airlock, a black ninja outfit, a bar (on which are a Glowing Sphere and a glittery box (closed)), a bench, a chair, a bartender, AFrame, and a securityBot here.

>i
You are carrying: 
a message receiver
a coin
a device from The Table of Stealth Devices
a dagger
(Health: 100)

>look message receiver
Dear Aaron, 

You really should meet me tonight in the Space Lounge...you're gonna be pumped! -AFrame

>look device
The device from The Table of Stealth Devices is kind of unremarkable, not really exciting like some cool crazy gun would be or something.

* * *

>Aaron
Aaron? Interesting, nice.

Space Lounge
You are in the Space Lounge. It's dim and glowy all over with pulsating colors and subtle hypnotic sounds.

You can see an airlock, a black ninja outfit, a bar (on which are a Glowing Sphere and a glittery box (closed)), a bench, a chair, a bartender, AFrame, and a securityBot here.

>look airlock
The airlock has a small window through which you can see a vast open space - is that a pool? Sweet!. It looks like the door only opens with a security key.

* * *

>Aaron
Aaron? Interesting, nice.

Space Lounge
You are in the Space Lounge. It's dim and glowy all over with pulsating colors and subtle hypnotic sounds.

You can see an airlock, a black ninja outfit, a bar (on which are a Glowing Sphere and a glittery box (closed)), a bench, a chair, a bartender, AFrame, and a securityBot here.

>look securityBot
Looks like a standard securityBot.

>look AFrame
Aframe is looking pretty sharp there wearing a pin-striped suit with his usual aplomb.

>AFrame, take off suit
He says "sure, anything for a laugh!"
AFrame takes off the pin-striped suit.

>AFrame, give me suit
He says "sure, anything for a laugh!"
AFrame is unable to do that.

>AFrame, drop suit
He says "sure, anything for a laugh!"
AFrame puts down the pin-striped suit.

>pick up suit
Taken.

>securityBot, take suit
The securityBot looks pissed. Maybe you outta not mess with securityBots...
1

>securityBot, take suit
you pissed off the securityBot one too many times, it precisely pulses a beam of pure energy all over your beautiful body and now you're dead

    *** The End ***

In that game you scored 0 out of a possible 0, in 8 turns.

Would you like to RESTART, RESTORE a saved game, QUIT, or UNDO the last command?

* * *

>Aaron McAaronson
Aaron McAaronson!? Aaaah, that's a good one.

Space Lounge
You are in the Space Lounge. It's dim and glowy all over with pulsating colors and subtle hypnotic sounds.

You can see an airlock, a black ninja outfit, a bar (on which are a Glowing Sphere and a glittery box (closed)), a bench, a comfy looking chair, a bartender, AFrame, and a securityBot here.

You can go east through the airlock (closed) and west from here.

>sit in chair
Oh boy this chair looks really soft and comfy! Ooooh ya you are totally gonna sit on this chair big time.

You get onto the comfy looking chair.

Sooooo comfy. So sooooo comfy. Mmmmm...

>stand up
You'd rather be asleep. Whatever other thing you would do besides being in this chair is a bad idea and not really that good of an option compared to being in this insanely comfy chair.

Sooooo comfy. So sooooo comfy. Mmmmm...

>stand up
You'd rather be asleep. Whatever other thing you would do besides being in this chair is a bad idea and not really that good of an option compared to being in this insanely comfy chair.

"I remember another life once, I think my name was Aaron McAaronson or Aaron or smthg", you think. Whateeeevs...this chair though...you look around the room entranced by the activity around you. Good thing you're not expending that much energy.

* * *

>Aaron The Greatest Man Who Ever Lived
Uh okay, and I'm Leeloo Minai Lekarariba-Laminai-Tchai Ekbat De Sebat. I can't handle these persons with ridic long names. Let's try this again - five names or less please.

What is your name?

>Aaron The Greatest
Oh, Aaron The Greatest eh!? I've heard a you.

Space Lounge
You are in the Space Lounge. It's dim and glowy all over with pulsating colors and subtle hypnotic sounds.

You can see an airlock, a black ninja outfit, a bar (on which are a Glowing Sphere and a glittery box (closed)), a bench, a comfy looking chair, a bartender, AFrame, and a securityBot here.

You can go east through the airlock (closed) and west from here.

>sit chair
I didn't understand that sentence.

>sit on chair
Oh boy this chair looks really soft and comfy! Ooooh ya you are totally gonna sit on this chair big time.

You get onto the comfy looking chair.

Oooh yes, this is a wonderful world. "What a luxuriously decadent and beautiful reality to be in" you think as you nestle further within the folds of the chair.

>stand up
You'd rather be asleep. Whatever other thing you would do besides being in this chair is a bad idea and not really that good of an option compared to being in this insanely comfy chair.

Oooh yes, this is a wonderful world. "What a luxuriously decadent and beautiful reality to be in" you think as you nestle further within the folds of the chair.

>stand up
You'd rather be asleep. Whatever other thing you would do besides being in this chair is a bad idea and not really that good of an option compared to being in this insanely comfy chair.

Oooh yes, this is a wonderful world. "What a luxuriously decadent and beautiful reality to be in" you think as you nestle further within the folds of the chair.

>stand up
You'd rather be asleep. Whatever other thing you would do besides being in this chair is a bad idea and not really that good of an option compared to being in this insanely comfy chair.

"What was I trying to do?" you think for a sec before you realize how comfy the chair you are in is. It's kind of incredible, you feel like you've accomplished enough in life.

>get off chair
You just can't get up, you are way too comfortable! Maybe if you just stayed here in this comfy looking chair forever you would be better off than whatever else you were going to do. Does it really matter?

"I remember another life once, I think my name was Aaron or Aaron The Greatest or smthg", you think. Whateeeevs...this chair though...you look around the room entranced by the activity around you. Good thing you're not expending that much energy.

>get off chair
You try to heave yourself up, but the soft lusciousness of the comfy looking chair envelopes you and pulls you back into its comfy folds. Oooooo...so comfy...so sooooooofffffft...

"I remember another life once, I think my name was Aaron or Aaron The Greatest or smthg", you think. Whateeeevs...this chair though...you look around the room entranced by the activity around you. Good thing you're not expending that much energy.

>get off chair
Whew! You just barely escaped that comfy looking chair, it's so comfy you could get stuck in it forever!

>securityBot, say hello
You say hello to the securityBot.

>securityBot, give me your lunch money
There is no reply.

>look securityBot
Looks like a standard securityBot. A floating ball of plastimetal about 3 feet in diameter with a bunch of creepy robot arms sticking out all over with cameras and sensors and whatever else all those things are. Is that a toothbrush? It's pretty unnerving to look at.

* * *

>Appleseed Dizzywitz
Hi, Appleseed!

Aaaah, that's a good one..

Space Lounge
You are in the Space Lounge. It's dim and glowy all over with pulsating colors and subtle hypnotic sounds.

You can see an airlock, a black ninja outfit, a bar (on which are a Glowing Sphere and a glittery box (closed)), a bench, a chair, a bartender, AFrame, and a Security bot here.

You can go east through the airlock (closed) from here.

(From here, you can move to east.)

* * *

>Big Dummy
Big Dummy!? Har har har! Musta been one-a them vat babies huh?.

Space Lounge
You are in the Space Lounge. It's dim and glowy all over with pulsating colors and subtle hypnotic sounds.

You can see an airlock, a black ninja outfit, a bar (on which are a Glowing Sphere and a glittery box (closed)), a bench, a chair, a bartender, AFrame, and a Security bot here.

You can go east through the airlock (closed) from here.

(From here, you can move to east.)

>look letter
Dear Big Dummy, 

You really should meet me tonight in the Space Lounge...you're gonna be pumped! -Ishar

* * *

>Bla Di Bla
Oh Bla Di Bla eh!? I've heard a you.

Space Lounge
You are in the Space Lounge. It's dim and glowy all over with pulsating colors and subtle hypnotic sounds.

You can see an airlock, a black ninja outfit, a bar (on which are a Glowing Sphere and a glittery box (closed)), a bench, a chair, a bartender, AFrame, and a Security bot here.

You can go east through the airlock (closed) from here.

(From here, you can move to east.)

>i
You are carrying: 
DiscoWig
a message receiver
a coin
a dagger
(Health: 100)

* * *

>Borovik Shevarra
Borovik Shevarra!? Aaaah, that's a good one.

Space Lounge
You are in the Space Lounge. It's dim and glowy all over with pulsating colors and subtle hypnotic sounds.

You can see an airlock, a black ninja outfit, a bar (on which are a Glowing Sphere and a glittery box (closed)), a bench, a chair, a bartender, AFrame, and a securityBot here.

>look AFrame
Aframe is looking pretty sharp there wearing a pin-striped suit with his usual aplomb.

* * *

>AFrame, take off suit
He says "sure, anything for a laugh!"
AFrame takes off the pin-striped suit.

>AFrame, drop suit
He says "sure, anything for a laugh!"
AFrame puts down the pin-striped suit.

>pick suit
I didn't understand that sentence.

>pick up suit
Taken.

>inv
You're carrying a pin-striped suit, a message receiver, a coin, and a dagger. You're wearing ElectroMisdirector.

>look security
You can't see any such thing.

>look securityBot
Looks like a standard securityBot. A floating ball of plastimetal about 3 feet in diameter with a bunch of creepy robot arms sticking out all over with cameras and sensors and whatever else all those things are. Is that a toothbrush? It's pretty unnerving to look at.

>look electromisdirector
A small device shaped like a horseshoe worn as a hat that misdirects any light coming towards your face upward. Kinda makes it look like you have no head. Totally legal (as long as you have the licensure information correctly processed of course). (Which you don't.)

>securityBot, take suit
The securityBot looks pissed. Maybe you outta not mess with securityBots...
1

>securityBot, take suit
You pissed off the securityBot one too many times. The securityBot's large and small and micro arms unfurl like a lotus made of cobras.  It's central power unit glows briefly and precisely pulses a beam of pure energy all over your beautiful body and now you're dead

    *** The End ***

In that game you scored 0 out of a possible 0, in 9 turns.

Would you like to RESTART, RESTORE a saved game, QUIT, or UNDO the last command?

* * *

>Cole
Cole!? Har har har! Musta been one-a them vat babies huh?

Space Lounge
You are in the Space Lounge. It's dim and glowy all over with pulsating colors and subtle hypnotic sounds.

You can see an airlock, a black ninja outfit, a bar (on which are a Glowing Sphere and a glittery box (closed)), a bench, a chair, a bartender, AFrame, and a Security bot here.

You can go east through the airlock (closed) and west from here.

(From here, you can move to east and west.)

>open the airlock
You open the airlock.

>east
As you enter the Veranda Walkway you see a floating dolphin surveillance pod.
Sweet it seems like your DiscoWig shielded you from detection. 

Veranda Walkway
Outside the Space Lounge you look out into the larger Raditree Building to see the pool under a high ceiling. Consuite lies beyond the pool in the main courtyard. Boffers beat each other up in the fenced in section of the courtyard.

You can see an airlock, a black rod, and a floating dolphin (closed) here.

You can go north, northeast, northwest, southeast, west through the airlock to the Space Lounge, up, and down from here.

(From here, you can move to north, northeast, northwest, southeast, west, up, and down.)

>se
Upper Southside Hallway
This hallway is NUTS - there are signs everywhere and lights and sounds flashing. From this hallway you can get into a bunch of Party Rooms

You can go north, northeast, northwest to the Veranda Walkway, south, southeast, and southwest from here.

(From here, you can move to north, northeast, northwest, south, southeast, and southwest.)

>se
Round1
Welcome to Trivia, I'm your host, a computer program super full of useless information. We have only one rule; please don't cheat - which means no looking stuff up using centralized data stores. Asking people around you is okay though I suppose.

Questions will be simple this round being worth five points a piece, but will increase in value as the game goes on.

Answers must be given with Capitalization and exact spelling.

Wrong answers will not be rewarded with correct answers - I'm not telling you the right answer. I have ONE singular accepted ABSOLUTELY CORRECT answer it's in a table and it is EXACT and PERFECT - I am the ULTIMATE IMPARTIAL QUIZ JUDGE. If you don't like it...cry me a spriver! OH also you are trapped within my quizzy embrace until the end so just accept your fate. Srsly don't try to leave or anything you'll just waste your answer-chances. The quiz is only four rounds of four questions each - just relax you're not stuck in a Quiz Vortex or anything...(I hope...)

-----------

The first section is on films involving simulated realities and questionable memories.

Who are you? Are you your memories? Are you what you have done? Are you what you will do? Or are you nothing at all but a wisp...or maybe "just" a program? 

You can go northwest to the Upper Southside Hallway from here.

(From here, you can move to northwest.)

In which movie did the main character die from super disturbing eye bulging decompression after helmet face plate breakage in the opening scene then but it turned it was just a dream? (or was it a premonition? or was it an implanted memory?)

Please enter your answer

>mars movie
Incorrect. Next question.

This movie has a sail boat smash into the end of a fake world. Everyone watching just goes totally nuts.

Please enter your answer

>Dark City
Incorrect. Next question.

In which film did someone get offered a choice between two pills and then didn't take both of them like they should have?

Please enter your answer

>The Matrix
Well done.  Next question.

This film has annoying gothy villians but a super cool reveal that everyone was in a giant space habitat the WHOLE TIME?! (btw foreshadowing...)

Please enter your answer

>Dune
That was Round One, now onto Round Two!

Round2
Now onto Round Two where the questions are worth ten points a piece. The subject of this round is Interactive Fiction! M(meta)E(meta)T(meta)A

You can see no obvious exits.

(There are no routes out of this room.)

This Apple II game features a game play element where the player is given a three-digit code at the beginning of play and is instructed to never reveal this code to anyone. At one point the game appears to crash as a way of tricking the player into revealing their code, in which case they lose the game. What is the name of this game?

Please enter your answer

>The Prisoner
Well done.  Next question.

In what game series are you likely to be eaten by a grue if you travel into dark places without a light source?

Please enter your answer

>Zork
Well done.  Next question.

Colossal Cave Adventure featured a "magic word" that caused teleportation and has shown up again and again in video games ever since.  It enables cheat modes, opens Easter Eggs and has inspired many silly programs. Type this magic word in lowercase now.

Please enter your answer

>xyzzy
Well done.  Next question.

Around 1975, a programmer and amateur caver wrote the first text adventure game whose name originally was all caps and only six characters long because of filename length limitations of that time. What is the name of this game (the all-caps six letter version)

Please enter your answer

>ADVENT
That was Round Two, now onto Round Three where things get a bit more difficult!

Round3
Round Three is here! The questions are harder but now worth fifteen points a piece. These ones are about going INSIDE THE COMPUTER!

You can see no obvious exits.

(There are no routes out of this room.)

What is the name of the anime about a VRMMORPG where the players have to play until they either die or someone beats the game? No logging out. WHAAaaaa? Wicked eh?

Please enter your answer

>Sword Art Online
Well done.  Next question.

This character started out as a real-life-human-reporter but after someone tried to kill him he ended up in a coma and then got his mind uploaded TO A COMPUTER. The transition altered his personality forever.

Please enter your answer

>Max Headroom
Well done.  Next question.

This 80"s movie about Virtual Reality was such garbage that it basically halted research and tech development in VR for about 20 years.

Please enter your answer

>The Lawnmower Man
Well done.  Next question.

Who is the actor who played the program Crom in Tron - you might also know him as Londo...

Please enter your answer

>Peter Jurasik
That was Round Three, now onto Round Four!

Round4
This is it, the final round. You're so close to escaping this quiz that not even a Quiz Vortex could keep you from exiting the quiz-field. The questions are worth twenty points a piece.

This round is about choices, random forces and what they lead to...which is of course PARALLEL UNIVERSES!

Every imagined-not-taken choice spawned from every individual's mind throughout time and space creating entire universes with every passing thought. The vast sea of thought embracing the infinite seeds of thought; the birth of what-ifs reflecting infinitely. 

You can see no obvious exits.

(There are no routes out of this room.)

Who wrote a series of stories about children travelling between parallel worlds with a powerful knife, and has book titles inspired by Paradise Lost?

Please enter your answer

>Philip Pullman
Well done.  Next question.

Who wrote The Coming of the Quantam Cats, which includes a parallel universe prison planet, and a triad -relationship including three different versions of the same person? (OMG that is so hawt!)

Please enter your answer

>Frederik Pohl
Well done.  Next question.

What is the name of the author who wrote about Sir Luther of Arkwright - a hero who can travel through the parallels at will?

Please enter your answer

>Bryan Talbot
Incorrect. Next question.

What movie about parallel universes involves a good version of Jet Li trying to stop an evil version of Jet Li who is determined to gain ultimate power by being the only version of himself throughout all universes?

Please enter your answer

>The One
Well done. That was the end of Round Four.

End
Final Score: 165/200

You can go northeast to the Upper Southside Hallway from here.

(From here, you can move to northeast.)

I didn't understand that sentence.

>inv
You're carrying a quizinator1, a message receiver, a coin, and a dagger. You're wearing DiscoWig.

[Your score has just gone up by one hundred sixty-five points.]

>look quizinator I
I only understood you as far as wanting to look the quizinator1.

>quizinator
I didn't understand that sentence.

>look quizinator
You got this for good quizinating!

* * *

>Dick Pusher
Dick Pusher!? Har har har! Musta been one-a them vat babies huh?

Space Lounge
You are in the Space Lounge. It's dim and glowy all over with pulsating colors and subtle hypnotic sounds.

You can see an airlock, a black ninja outfit, a bar (on which are a Glowing Sphere and a glittery box (closed)), a bench, a chair, a bartender, AFrame, and a Security bot here.

You can go east through the airlock (closed) from here.

(From here, you can move to east.)

* * *

>Dipshit
I didn't understand that sentence.

What is your name?

>Dipshit Hafflelnsauce
I didn't understand that sentence.

What is your name?

>asdf asdf asdf asdf asd fa dsfas dfas dfa sdf asdf
Who are you, a member of the British royal family? No one has that many names. Let's try this again.

What is your name?

>asdf asdf
I didn't understand that sentence.

What is your name?

>asdf asdf asdf
I didn't understand that sentence.

What is your name?

>asdf asdf asdf asdf asdf
I didn't understand that sentence.

What is your name?

>asdf asdf asdf asfd asfd asdf
Who are you, a member of the British royal family? No one has that many names. Let's try this again.

What is your name?

* * *

>Dumbshit Shitterwithers
Hi, Dumbshit!

Oh Dumbshit Shitterwithers eh!? I've heard a you..

Space Lounge
You are in the Space Lounge. It's dim and glowy all over with pulsating colors and subtle hypnotic sounds.

You can see an airlock, a black ninja outfit, a bar (on which are a Glowing Sphere and a glittery box (closed)), a bench, a chair, a bartender, AFrame, and a Security bot here.

You can go east through the airlock (closed) from here.

(From here, you can move to east.)

* * *

>Fancy footwork
Oh Fancy footwork eh!? I've heard a you.

Space Lounge
You are in the Space Lounge. It's dim and glowy all over with pulsating colors and subtle hypnotic sounds.

You can see an airlock, a black ninja outfit, a bar (on which are a Glowing Sphere and a glittery box (closed)), a bench, a chair, a bartender, AFrame, and a Security bot here.

You can go east through the airlock (closed) from here.

(From here, you can move to east.)

>look letter
Dear Fancy, 

You really should meet me tonight in the Space Lounge...you're gonna be pumped! -AFrame

* * *

>Fuck My Face
Oh, Fuck My Face eh!? I've heard a you.

Space Lounge
You are in the Space Lounge. It's dim and glowy all over with pulsating colors and subtle hypnotic sounds.

You can see an airlock, a black ninja outfit, a bar (on which are a Glowing Sphere and a glittery box (closed)), a bench, a chair, a bartender, AFrame, and a securityBot here.

You can go east through the airlock (closed) and west from here.

* * *

>Hey Dude
h, Hey Dude eh!? I've heard a you.

Space Lounge
You are in the Space Lounge. It's dim and glowy all over with pulsating colors and subtle hypnotic sounds.

You can see an airlock, a black ninja outfit, a bar (on which are a Glowing Sphere and a glittery box (closed)), a bench, a comfy looking chair, a bartender, AFrame, and a securityBot here.

You can go east through the airlock (closed) and west from here.

>e
(first opening the airlock)
As you enter the Veranda Walkway you see a floating dolphin surveillance pod.
Sweet it seems like your DiscoWig shielded you from detection. 

Veranda Walkway
Outside the Space Lounge you look out into the larger Raditree Building to see the pool under a high ceiling. Consuite lies beyond the pool in the main courtyard. Boffers beat each other up in the fenced in section of the courtyard. There's a floating platform above the pool.

You can see an airlock, a black rod, and a floating dolphin (closed) here.

You can go north, northeast, northwest, southeast, west through the airlock to the Space Lounge, up, and down from here.

>nw
Bridge
The Bridge

You can go southeast to the Veranda Walkway from here.

>se
As you enter the Veranda Walkway you see a floating dolphin surveillance pod.
Sweet it seems like your DiscoWig shielded you from detection. 

Veranda Walkway
Outside the Space Lounge you look out into the larger Raditree Building to see the pool under a high ceiling. Consuite lies beyond the pool in the main courtyard. Boffers beat each other up in the fenced in section of the courtyard. There's a floating platform above the pool.

You can see an airlock, a black rod, and a floating dolphin (closed) here.

You can go north, northeast, northwest to the Bridge, southeast, west through the airlock to the Space Lounge, up, and down from here.

>d
Under the Veranda Walkway
You can go north, northeast, southeast, east, west, and up to the Veranda Walkway from here.

>e
Garden Court
Garden Court

You can see a boffer here.

You can go west to Under the Veranda Walkway from here.

>talk boffer
I didn't understand that sentence.

>hit boffer
Violence isn't the answer to this one.

>stab boffer
I didn't understand that sentence.

>stab boffer with knife
I didn't understand that sentence.

>i
You're carrying a message receiver, a coin, and a dagger. You're wearing DiscoWig.

>stab boffer with dagger
I didn't understand that sentence.

>look DiscoWig
This wig is all sproingy and is made of tons of tiny pieces of holographic metallic rainbow shards. As you move about the light around you is refracted into a million directions, making face recog almost impossible.

* * *

>Kiss My Assimus
Kiss My Assimus! Aaaah, that's a good one.

Space Lounge
You are in the Space Lounge. It's dim and glowy all over with pulsating colors and subtle hypnotic sounds.

You can see an airlock, a black ninja outfit, a bar (on which are a Glowing Sphere and a glittery box (closed)), a bench, a chair, a bartender, AFrame, and a Security bot here.

You can go east through the airlock (closed) and west from here.

(From here, you can move to east and west.)

>e
(first opening the airlock)
As you enter the Veranda Walkway you see a floating dolphin surveillance pod.
Sweet it seems like your DiscoWig shielded you from detection. 

Veranda Walkway
Outside the Space Lounge you look out into the larger Raditree Building to see the pool under a high ceiling. Consuite lies beyond the pool in the main courtyard. Boffers beat each other up in the fenced in section of the courtyard.

You can see an airlock, a black rod, and a floating dolphin (closed) here.

You can go north, northeast, northwest, southeast, west through the airlock to the Space Lounge, up, and down from here.

(From here, you can move to north, northeast, northwest, southeast, west, up, and down.)

>open floating dophin
I only understood you as far as wanting to open the floating dolphin.

>se
Upper Southside Hallway
This hallway is NUTS - there are signs everywhere and lights and sounds flashing. From this hallway you can get into a bunch of Party Rooms

You can go north, northeast, northwest to the Veranda Walkway, south, southeast, and southwest from here.

(From here, you can move to north, northeast, northwest, south, southeast, and southwest.)

>se
Round1
Welcome to Trivia, I'm your host, a computer program just chock full of useless information. We have only one rule; please don't cheat - no looking stuff up using centralized data stores. Asking people around you is okay though I suppose. Questions will be simple this round being worth five points a piece, but will increase in both difficulty and value as the game goes on.

This first section is on films involving simulated realities and questionable memories.

Who are you? Are you your memories? Are you what you have done? Are you what you will do? Or are you nothing at all but a wisp...or maybe "just" a program? 

You can go northwest to the Upper Southside Hallway from here.

(From here, you can move to northwest.)

In which film did someone get offered a choice between two pills and then didn't take both of them like they should have?

Please enter your answer

>nw
Incorrect. Next question.

This movie has a sail boat smash into the end of a fake world. Everyone watching just goes totally nuts.

Please enter your answer

>The Truman Show
Well done.  Next question.

This film has annoying gothy villians but a super cool reveal that everyone was in a giant space habitat the WHOLE TIME?! (btw foreshadowing...)

Please enter your answer

>Dark City
Well done.  Next question.

In which movie did the main character die from super disturbing eye bulging decompression after helmet face plate breakage in the opening scene then but it turned it was just a dream? (or was it a premonition? or was it an implanted memory?)

Please enter your answer

>Total Recall
That was Round One, now onto Round Two!

Round2
Now onto Round Two where the questions get slightly harder but are worth ten points a piece.

You can see no obvious exits.

(There are no routes out of this room.)

In the contract version of what card game are players identified by points on the compass?

Please enter your answer

* * *

>Looky Dear
Oh Looky Dear eh!? I've heard a you.

Space Lounge
You are in the Space Lounge. It's dim and glowy all over with pulsating colors and subtle hypnotic sounds.

You can see an airlock, a black ninja outfit, a bar (on which are a Glowing Sphere and a glittery box (closed)), a bench, a chair, a bartender, AFrame, and a Security bot here.

You can go east through the airlock (closed) from here.

(From here, you can move to east.)

>talk AFrame
I didn't understand that sentence.

* * *

>Me
Me? Interesting, nice.

Space Lounge
You are in the Space Lounge. It's dim and glowy all over with pulsating colors and subtle hypnotic sounds.

You can see an airlock, a black ninja outfit, a bar (on which are a Glowing Sphere and a glittery box (closed)), a bench, a comfy looking chair, a bartender, AFrame, and a securityBot here.

You can go east through the airlock (closed) and west from here.

>sit in chair
Oh boy this chair looks really soft and comfy! Ooooh ya you are totally gonna sit on this chair big time.

You get onto the comfy looking chair.

Oooh yes, this is a wonderful world. "What a luxuriously decadent and beautiful reality to be in" you think as you nestle further within the folds of the chair.

>get off chair
You just can't get up, you are way too comfortable! Maybe if you just stayed here in this comfy looking chair forever you would be better off than whatever else you were going to do. Does it really matter?

Sooooo comfy. So sooooo comfy. Mmmmm...

>get off chair
You try to heave yourself up, but the soft lusciousness of the comfy looking chair envelopes you and pulls you back into its comfy folds. Oooooo...so comfy...so sooooooofffffft...

"I remember another life once, I think my name was Me or Me or smthg", you think. Whateeeevs...this chair though...you look around the room entranced by the activity around you. Good thing you're not expending that much energy.

* * *

>Reginald Bartholemew Johansen Brauwnshittinger the 5th
Who are you, a member of the British royal family? No one has that many names. Let's try this again.

What is your name?

>Han Solo
Oh Han Solo eh!? I've heard a you..

Space Lounge
You are in the Space Lounge. It's dim and glowy all over with pulsating colors and subtle hypnotic sounds.

You can see an airlock, a black ninja outfit, a bar (on which are a Glowing Sphere and a glittery box (closed)), a bench, a chair, a bartender, AFrame, and a Security bot here.

You can go east through the airlock (closed) from here.

(From here, you can move to east.)

>look letter
Dear Han Solo, 

You really should meet me tonight in the Space Lounge...you're gonna be pumped! -Ishar

>e
(first opening the airlock)

Veranda Walkway
Outside the Space Lounge you look out into the larger Raditree Building to see the pool with under a high ceiling. Consuite lies beyond the pool in the main courtyard. Boffers beat each other up in the fenced in section of the courtyard. A floating dolphin surveillance pod floats by making you twitch instintively to make your shiny wig come between the camera and your face.

You can see an airlock, a black rod, and a floating dolphin (closed) here.

You can go north, northeast, northwest, southeast, west through the airlock to the Space Lounge, up, and down from here.

(From here, you can move to north, northeast, northwest, southeast, west, up, and down.)

>down
Under the Veranda Walkway
You can go north, northeast, southeast, east, west, and up to the Veranda Walkway from here.

(From here, you can move to north, northeast, southeast, east, west, and up.)

>ne
Lower Northside Hallway
Lower Northside Hallway (party rooms)

You can go north, southeast, and southwest to Under the Veranda Walkway from here.

(From here, you can move to north, southeast, and southwest.)

>sw
Under the Veranda Walkway
You can go north, northeast to Lower Northside Hallway, southeast, east, west, and up to the Veranda Walkway from here.

(From here, you can move to north, northeast, southeast, east, west, and up.)

>e
Garden Court
Garden Court

You can see a boffer here.

You can go west to Under the Veranda Walkway from here.

(From here, you can move to west.)

The boffer stabs you! (Health: 91)

>attack boffer
Violence isn't the answer to this one.

The boffer stabs you! (Health: 84)

>stab boffer
What do you want to stab the boffer with?

>stab boffer with dagger
You stab the boffer with your the dagger. The boffer yells out in pain.  (The boffer's health: 90)

The boffer stabs you! (Health: 76)

>stab boffer
What do you want to stab the boffer with?

>stab boffer with dagger
You stab the boffer with your the dagger. The boffer yells out in pain.  (The boffer's health: 68)

The boffer stabs you! (Health: 69)

>stab boffer with dagger
You stab the boffer with your the dagger. The boffer yells out in pain.  (The boffer's health: 56)

The boffer stabs you! (Health: 62)

>stab boffer with dagger
You stab the boffer with your the dagger. The boffer yells out in pain.  (The boffer's health: 41)

The boffer stabs you! (Health: 55)

>stab boffer with dagger
You stab the boffer with your the dagger. The boffer yells out in pain.  (The boffer's health: 29)

The boffer stabs you! (Health: 47)

>stab boffer with dagger
You stab the boffer with your the dagger. The boffer yells out in pain.  (The boffer's health: 5)

The boffer stabs you! (Health: 37)

>stab boffer with dagger
With one final thrust of your dagger, the boffer's dead body drops to the ground, dead.

>look boffer
boffer's dead body is a gruesome sight.

>search boffer
You search the boffer's dead body and find the nanocarbon staff and the nanocarbon blade.

>look nanocarbon staff
Nanocarbon staff, looks just like oldwood. Looks like it can be switched between stun and realdammo.

>look nanocarbon blade
The nanocarbon blade is kind of unremarkable, not really exciting like some cool crazy gun would be or something.

>i
You are carrying: 
a letter
a coin
a wig
a dagger
(Health: 37)

>take nanocarbon staff
Taken.

>take nanocarbon blade
Taken.

>i
You are carrying: 
a nanocarbon blade
a nanocarbon staff
a letter
a coin
a wig
a dagger
(Health: 37)

>look coin
The coin is kind of unremarkable, not really exciting like some cool crazy gun would be or something.

>look wig
This wig is super shiny and silvery, reflecting light off in all directions, it helps you avoid being face-detected by the intero-pods.

* * *

>Sue May Shuringhousen the 5th and stuff
Who are you, a member of the British royal family? No one has that many names. Let's try this again.

What is your name?

>Kelly Anne Elizabeth Shaw
Kelly Anne Elizabeth Shaw!? Har har har! Musta been one-a them vat babies huh?

Space Lounge
You are in the Space Lounge. It's dim and glowy all over with pulsating colors and subtle hypnotic sounds.

You can see an airlock, a black ninja outfit, a bar (on which are a Glowing Sphere and a glittery box (closed)), a bench, a chair, a bartender, AFrame, and a Security bot here.

You can go east through the airlock (closed) from here.

(From here, you can move to east.)

* * *

>Super
Super? Interesting, nice.

Space Lounge
You are in the Space Lounge. It's dim and glowy all over with pulsating colors and subtle hypnotic sounds.

You can see an airlock, a black ninja outfit, a bar (on which are a Glowing Sphere and a glittery box (closed)), a bench, a chair, a bartender, AFrame, and a Security bot here.

You can go east through the airlock (closed) from here.

(From here, you can move to east.)

>i
You are carrying: 
DiscoWig
a message receiver
a coin
a dagger
(Health: 100)

* * *

>Super Dupe
Super Dupe!? Har har har! Musta been one-a them vat babies huh?

Space Lounge
You are in the Space Lounge. It's dim and glowy all over with pulsating colors and subtle hypnotic sounds.

You can see an airlock, a black ninja outfit, a bar (on which are a Glowing Sphere and a glittery box (closed)), a bench, a chair, a bartender, AFrame, and a Security bot here.

You can go east through the airlock (closed) from here.

(From here, you can move to east.)

>look letter
Dear Super, 

You really should meet me tonight in the Space Lounge...you're gonna be pumped! -Ishar

* * *

>Super Duper
Super Duper!? Har har har! Musta been one-a them vat babies huh?

Space Lounge
You are in the Space Lounge. It's dim and glowy all over with pulsating colors and subtle hypnotic sounds.

You can see an airlock, a black ninja outfit, a bar (on which are a Glowing Sphere and a glittery box (closed)), a bench, a chair, a bartender, AFrame, and a Security bot here.

You can go east through the airlock (closed) from here.

(From here, you can move to east.)

* * *

>a-ron
a-ron!? Aaaah, that's a good one.

Space Lounge
You are in the Space Lounge. It's dim and glowy all over with pulsating colors and subtle hypnotic sounds.

You can see an airlock, a black ninja outfit, a bar (on which are a Glowing Sphere and a glittery box (closed)), a bench, a comfy looking chair, a bartender, AFrame, and a securityBot here.

You can go east through the airlock (closed) and west from here.

>i
You're carrying a message receiver, a coin, and a dagger. You're wearing AdBlaster2000.

>look message
Dear a, 

You really should meet me tonight in the Space Lounge...you're gonna be pumped! -AFrame

>ask aframe about xx
When you mention xx, Aframe's eyes light up. He smiles and looks around the room for a second before stepping closer to you. "How do you know aobut xx?", he says - well it doesn't matter now - just remember yy when you get to the zz okay? DON'T FORGET ABOUT THE YY! Then he looks around again and slowly fades from view, like all the color faded to grey, then all the outlines of his features just slowly alpha-fade to zero. He also shrank somehow too. Your mind drifts a bit into thoughts about 4D movement and that Aframe might be some kind of hyperdimensional being.

>attack bartender
You attack the bartender, causing 10 points of damage! The bartender has -10 hit points
The bartender is defeated! He stands up and gives you his staff, "Nobody has defeated me in a long time. This is yours now."

* * *

>aaron
aaron!? Aaaah, that's a good one.

Space Lounge
You are in the Space Lounge. It's dim and glowy all over with pulsating colors and subtle hypnotic sounds.

You can see an airlock, a black ninja outfit, a bar (on which are a Glowing Sphere and a glittery box (closed)), a bench, a chair, a bartender, AFrame, and a Security bot here.

>look black ninja outfit
This is a ninja outfit, it's black and has a hood that covers your face. It has pockets in it to store cool ninja gear. It has these sweet built in booties that muffle your footsteps as if you were a total ninja, which you totally are if you are wearing this outfit. You could sneak around a place with shadows without being detected if you were wearing this thing. You'd be so ninja.

The pocket contains nothing.

>wear ninja outfit
(first taking the black ninja outfit)
You are a ninja! It feels like you could blend into the shadows, or maybe you ARE the shadows, this ninja outfit makes you feel super ninja-like

>look pocket
The pocket is kind of unremarkable, not really exciting like some cool crazy gun would be or something.

>look inside pockets
You can't use multiple objects with that verb.

>inv
You're carrying a message receiver, a coin, and a dagger. You're wearing a black ninja outfit and ElectroMisdirector.

>look ninja outfit
This is a ninja outfit, it's black and has a hood that covers your face. It has pockets in it to store cool ninja gear. It has these sweet built in booties that muffle your footsteps as if you were a total ninja, which you totally are if you are wearing this outfit. You could sneak around a place with shadows without being detected if you were wearing this thing. You'd be so ninja.

The pocket contains nothing.

>look black ninja outfit
This is a ninja outfit, it's black and has a hood that covers your face. It has pockets in it to store cool ninja gear. It has these sweet built in booties that muffle your footsteps as if you were a total ninja, which you totally are if you are wearing this outfit. You could sneak around a place with shadows without being detected if you were wearing this thing. You'd be so ninja.

The pocket contains nothing.

* * *

>aaron prust
aaron prust!? Aaaah, that's a good one.

Space Lounge
You are in the Space Lounge. It's dim and glowy all over with pulsating colors and subtle hypnotic sounds.

You can see an airlock, a black ninja outfit, a bar (on which are a Glowing Sphere and a glittery box (closed)), a bench, a comfy looking chair, a bartender, AFrame, and a securityBot here.

You can go east through the airlock (closed) and west from here.

>e
(first opening the airlock)

H2K
Hallway2K

You can see an airlock here.

You can go north, south, and west through the airlock to the Space Lounge from here.

>n
H2I
Hallway2I

You can go north, south to H2K, and west from here.

>w
Registration
Registration

You can go east to H2I from here.

>e
H2I
Hallway2I

You can go north, south to H2K, and west to Registration from here.

* * *

>aaron prust
aaron prust!? Aaaah, that's a good one.

Space Lounge
You are in the Space Lounge. It's dim and glowy all over with pulsating colors and subtle hypnotic sounds.

You can see an airlock, a black ninja outfit, a bar (on which are a Glowing Sphere and a glittery box (closed)), a bench, a comfy looking chair, a bartender, AFrame, and a securityBot here.

You can go east through the airlock (closed) and west from here.

>sit on chair
Oh boy this chair looks really soft and comfy! Ooooh ya you are totally gonna sit on this chair big time.

You get onto the chair.

on a soft thing

>get off of chair
You can't see any such thing.

>get off chair
You just can't get up, you are way too comfortable! Maybe if you just stayed here in this chair forever you would be better off than whatever else you were going to do. Does it really matter?

on a soft thing

>get off chair
You try to heave yourself up, but the soft lusciousness of the chair envelopes you and pulls you back into its comfy folds. Oooooo...so comfy...so sooooooofffffft...

on a soft thing

>get off chair
Whew! You just barely escaped that chair, it's so comfy you could get stuck in it forever!

>sit on chair
Oh boy this chair looks really soft and comfy! Ooooh ya you are totally gonna sit on this chair big time.

"Hey Wait!" your subconscious jumps forth remembering the tempting softness - you decide not not to sit on that chair, it's so comfy you might never get up again! It looks seriously comfy though...maybe just for a little tiny sliver of a moment you could get kinda comfy...

>sit on chair
Oh boy this chair looks really soft and comfy! Ooooh ya you are totally gonna sit on this chair big time.

Don't you remember the last time you were in that chair? It almost ATE YOU! What is your deal? Don't sit in this chair, it's too dangerous! Only a master of mental projection could sit on this chair without its super soft comfy-ness obliterating and subsuming your soul to its dark comfy desires.

>sit on chair
Oh boy this chair looks really soft and comfy! Ooooh ya you are totally gonna sit on this chair big time.

    *** You sit on the chair again and sink forever into its comfyness. You never rise again. ***

In that game you scored 0 out of a possible 0, in 7 turns.

Would you like to RESTART, RESTORE a saved game, QUIT, or UNDO the last command?

>restart
In the early 2000s, mewonkind's folly led to the breakdown of society and the restructuring of general cultural and technological vector-goals. At some point interest-tribes formed into coherent anarcho-syndicates, creating new economic models which began to isolate themselves in order to maximize survival attributes and minimize unknown variable influences. It was around that time the blast doors went down. Nobody's sure how long exactly; it's been hundreds of season renewals and a ton of spin-offs and crossovers since then though. At least that's what you were taught in data-download segment 2-histori-political info part 27A while syncing the standard edu-packets. Who the hell knows for real though, right?

Whatevs. Feels like just another day in the MASSIVE HIVE KNOWN as CONvergence.

You have more than a couple enemies.

Today's magic number is 478.

What is your name?

>gobbledy gook
gobbledy gook!? Har har har! Musta been one-a them vat babies huh?

Space Lounge
You are in the Space Lounge. It's dim and glowy all over with pulsating colors and subtle hypnotic sounds.

You can see an airlock, a black ninja outfit, a bar (on which are a Glowing Sphere and a glittery box (closed)), a bench, a chair, a bartender, AFrame, and a securityBot here.

>look AFrame
Aframe is looking pretty sharp there wearing a pin-striped suit with his usual aplomb.

>talk to AFrame
You say hello to AFrame.

>talk to bartender
You say hello to the bartender.

>look box
Time slows down, you feel as if you are gazing into the cosmos itself. Your eyeballs can hardly stay on it, it's like your gaze just keeps sliding off.

>look box
Time slows down, you feel as if you are gazing into the cosmos itself. Your eyeballs can hardly stay on it, it's like your gaze just keeps sliding off.

>open box
You open the glittery box, revealing a securityReadout, a bowl, and a crazy looking gun.

>look gun
That gun is so crazy looking! It's kind of like totally blowing your mind.

>look securityReadout
The screen is blank.

The securityReadout is currently switched off.

>look bowl
The bowl is kind of unremarkable, not really exciting like some cool crazy gun would be or something.

In the bowl is a note.

* * *

>actions
Actions listing on.

>open airlock
[opening the airlock]
(first unlocking the airlock)
[(1) unlocking keylessly the airlock - silently]
You lack a key that fits the airlock.
[(1) unlocking keylessly the airlock - silently - failed the check keylessly unlocking rule]

[opening the airlock - failed the check keylessly unlocking rule]

>look sphere
[examining the Glowing Sphere]
OOOOoooo glowy-sphere thingie! Its purple soft glow makes you feel safe and secure. It looks like there's some sort of helix-key as a component to the glowy-ness but it's unclear how you would remove it.

[examining the Glowing Sphere - succeeded]

>take key
[taking the security key]
That seems to be a part of the Glowing Sphere.
[taking the security key - failed the can't take component parts rule]

>take gun
You can't see any such thing.

>open box
[opening the glittery box]
You open the glittery box, revealing a security readout, a bowl, and a crazy looking gun.
[opening the glittery box - succeeded]

>take gun
[taking the crazy looking gun]
You have no idea what this gun does. You've never seen anything like it! You're pretty stoked to get this gun.

Taken.
[taking the crazy looking gun - succeeded]

>shoot self
(with the crazy looking gun)
[shooting yourself with the crazy looking gun]
That would be disastrous!
[shooting yourself with the crazy looking gun - failed the Check shooting something with something]

>shoot bar
(with the crazy looking gun)
[shooting the bar with the crazy looking gun]
ZAP! The bar twinkles out of existence! 

[shooting the bar with the crazy looking gun - succeeded]

>look
[looking]
Space Lounge
You are in the Space Lounge, rumored to be the center of The Resistance. "Why did I come here?" you briefly wonder before looking around.

You can see an airlock, a chair, a bench, and a bartender here.

[looking - succeeded]

>sit chair
I didn't understand that sentence.

>sit on chair
[entering the chair]
Oh boy this chair looks really soft and comfy! Ooooh ya you are totally gonna sit on this chair big time.

You sit down and are so comfortable - you could really get used to being in this chair.
[entering the chair - succeeded]

"What a lovely soft and dreamy world", you think. Nothing is wrong and everything is right. Right and soft. Sooooo sooooofffft.

>look
[looking]
Space Lounge (on the chair)
You are in the Space Lounge, rumored to be the center of The Resistance. "Why did I come here?" you briefly wonder before looking around.

You can see an airlock, a bench, and a bartender here.

[looking - succeeded]

"What a lovely soft and dreamy world", you think. Nothing is wrong and everything is right. Right and soft. Sooooo sooooofffft.

>get up
[exiting]
You'd rather be asleep.
[exiting - failed]

"What a lovely soft and dreamy world", you think. Nothing is wrong and everything is right. Right and soft. Sooooo sooooofffft.

>get up
[exiting]
You'd rather be asleep.
[exiting - failed]

"What a lovely soft and dreamy world", you think. Nothing is wrong and everything is right. Right and soft. Sooooo sooooofffft.

>stand
[exiting]
You'd rather be asleep.
[exiting - failed]

"What a lovely soft and dreamy world", you think. Nothing is wrong and everything is right. Right and soft. Sooooo sooooofffft.

>exit chair
I only understood you as far as wanting to exit.

>get out of chair
I only understood you as far as wanting to get outside.

>get up from chair
[getting off the chair]
You just can't get up, you are way too comfortable!
[getting off the chair - failed]

"What a lovely soft and dreamy world", you think. Nothing is wrong and everything is right. Right and soft. Sooooo sooooofffft.

>get up from chair
[getting off the chair]
You try to heave yourself up, but the soft lusciousness of the chair envelopes you and pulls you back into its comfy folds.
[getting off the chair - failed]

"What a lovely soft and dreamy world", you think. Nothing is wrong and everything is right. Right and soft. Sooooo sooooofffft.

>get up from chair
[getting off the chair]
[getting off the chair - failed]

"What a lovely soft and dreamy world", you think. Nothing is wrong and everything is right. Right and soft. Sooooo sooooofffft.

>get up from chair
[getting off the chair]
Whew! You just barely escaped that chair, it's so comfy you could get stuck in it forever!
[getting off the chair - succeeded]

>get up from chair
[getting off the chair]
But you aren't on the chair at the moment.
[getting off the chair - failed the can't get off things rule]

>sit on chair
[entering the chair]
Oh boy this chair looks really soft and comfy! Ooooh ya you are totally gonna sit on this chair big time.

"Hey Wait!" your subconscious jumps forth remembering the tempting softness - you decide not not to sit on that chair, it's so comfy you might never get up again!
[entering the chair - failed]

>sit on chair
[entering the chair]
Oh boy this chair looks really soft and comfy! Ooooh ya you are totally gonna sit on this chair big time.

"Hey Wait!" your subconscious jumps forth remembering the tempting softness - you decide not not to sit on that chair, it's so comfy you might never get up again!
[entering the chair - failed]

>sit on bench
[entering the bench]
You get onto the bench.

[entering the bench - succeeded]

>look
[looking]
Space Lounge (on the bench)
You are in the Space Lounge, rumored to be the center of The Resistance. "Why did I come here?" you briefly wonder before looking around.

You can see an airlock, a chair, and a bartender here.

[looking - succeeded]

>show me wig
[showing the wig to yourself]
[(1) examining the wig]
This wig is super shiny and silvery, reflecting light off in all directions, it helps you avoid being face-detected by the intero-pods.

[(1) examining the wig - succeeded]

[showing the wig to yourself - succeeded]

>undo
Space Lounge
[Previous turn undone.]

>look
[looking]
Space Lounge (on the bench)
You are in the Space Lounge, rumored to be the center of The Resistance. "Why did I come here?" you briefly wonder before looking around.

You can see an airlock, a chair, and a bartender here.

[looking - succeeded]

* * *

>ad
Oh, ad eh!? I've heard a you.

Space Lounge
You are in the Space Lounge. It's dim and glowy all over with pulsating colors and subtle hypnotic sounds.

You can see an airlock, a black ninja outfit, a bar (on which are a Glowing Sphere and a glittery box (closed)), a bench, a comfy looking chair, a bartender, AFrame, and a securityBot here.

You can go east through the airlock (closed) and west from here.

>give coin to bartender
She accepts with a smile and slides you a smoothie. It looks friggin delicious.

>i
You are carrying: 
RocketBlaster
ElectroMisdirector
a message receiver
a dagger
(Health: 100)

* * *

>ad
Oh, ad eh!? I've heard a you.

Space Lounge
You are in the Space Lounge. It's dim and glowy all over with pulsating colors and subtle hypnotic sounds.

You can see an airlock, a black ninja outfit, a bar (on which are a Glowing Sphere and a glittery box (closed)), a bench, a comfy looking chair, a bartender, AFrame, and a securityBot here.

You can go east through the airlock (closed) and west from here.

>look
Space Lounge
You are in the Space Lounge. It's dim and glowy all over with pulsating colors and subtle hypnotic sounds.

You can see an airlock, a black ninja outfit, a bar (on which are a Glowing Sphere and a glittery box (closed)), a bench, a comfy looking chair, a bartender, AFrame, and a securityBot here.

You can go east through the airlock (closed) and west from here.

>inventory
You are carrying: 
ElectroMisdirector
a message receiver
a coin
a dagger
(Health: 100)

>help
Space Lounge
You are in the Space Lounge. It's dim and glowy all over with pulsating colors and subtle hypnotic sounds.

You can see an airlock, a black ninja outfit, a bar (on which are a Glowing Sphere and a glittery box (closed)), a bench, a comfy looking chair, a bartender, AFrame, and a securityBot here.

You can go east through the airlock (closed) and west from here.

>i
You are carrying: 
ElectroMisdirector
a message receiver
a coin
a dagger
(Health: 100)

>look E
You see nothing unexpected in that direction.

>look ElectroMisdirector
A small device shaped like a horseshoe worn as a hat that misdirects any light coming towards your face upward. Kinda makes it look like you have no head. Totally legal (as long as you have the licensure information correctly processed of course). (Which you don't.)

>look message receiver
Dear ad, 

You really should meet me tonight in the Space Lounge...you're gonna be pumped! -AFrame

>Aframe, take off suit
He says "sure, anything for a laugh!"
AFrame takes off the pin-striped suit.

>Aframe, put on suit
He says "sure, anything for a laugh!"
AFrame puts on the pin-striped suit.

>take pin striped suit
You can't see any such thing.

>Aframe, bla
There is no reply.

>ask Aframe about xx
When you mention xx, Aframe's eyes light up. He smiles and looks around the room for a second before stepping closer to you. "How do you know aobut xx?", he says - well it doesn't matter now - just remember yy when you get to the zz okay? DON'T FORGET ABOUT THE YY! Then he looks around again and slowly fades from view, like all the color faded to grey, then all the outlines of his features just slowly alpha-fade to zero.

>look
Space Lounge
You are in the Space Lounge. It's dim and glowy all over with pulsating colors and subtle hypnotic sounds.

You can see an airlock, a black ninja outfit, a bar (on which are a Glowing Sphere and a glittery box (closed)), a bench, a comfy looking chair, a bartender, and a securityBot here.

You can go east through the airlock (closed) and west from here.

>open bos
You can't see any such thing.

>open box
You open the glittery box, revealing a securityReadout, a bowl, and a crazy looking gun.

>take gun
You have no idea what this gun does. You've never seen anything like it! You're pretty stoked to get this gun.

Taken.

>shoot sphere with gun
You need a projectile weapon to shoot anything.

* * *

>adf
Oh, adf eh!? I've heard a you.

Space Lounge
You are in the Space Lounge. It's dim and glowy all over with pulsating colors and subtle hypnotic sounds.

You can see an airlock, a black ninja outfit, a bar (on which are a Glowing Sphere and a glittery box (closed)), a bench, a comfy looking chair, a bartender, AFrame, and a securityBot here.

nothing

>attack Aframe
You attack AFrame, causing 4 points of damage!

AFrame is defeated! He stands up and gives you his staff, "Nobody has defeated me in a long time. This is yours now."

* * *

>adf
Oh, adf eh!? I've heard a you.

Space Lounge
You are in the Space Lounge. It's dim and glowy all over with pulsating colors and subtle hypnotic sounds.

You can see an airlock, a black ninja outfit, a bar (on which are a Glowing Sphere and a glittery box (closed)), a bench, a comfy looking chair, a bartender, AFrame, and a securityBot here.

nothing

>attack aframe
You attack AFrame, causing 8 points of damage! AFrame has 992 hit points
AFrame attacks you, causing 6 points of damage! You have 4 hit points

>e
(first opening the airlock)
As you enter the Veranda Walkway you see a floating dolphin surveillance pod.
Sweet it seems like your AdBlaster2000 shielded you from detection. 

Veranda Walkway
Outside the Space Lounge you look out into the larger Raditree Building to see the pool under a high ceiling. Consuite lies beyond the pool in the main courtyard. Boffers beat each other up in the fenced in section of the courtyard. There's a floating platform above the pool.

You can see an airlock, a black rod, and a floating dolphin (closed) here.

You can go north, northeast, northwest, southeast, west through the airlock to the Space Lounge, up, and down from here.

* * *

>adf
Oh, adf eh!? I've heard a you.

Space Lounge
You are in the Space Lounge. It's dim and glowy all over with pulsating colors and subtle hypnotic sounds.

You can see an airlock, a black ninja outfit, a bar (on which are a Glowing Sphere and a glittery box (closed)), a bench, a comfy looking chair, a bartender, AFrame, and a securityBot here.

nothing

>attack bartender
You attack the bartender, causing 9 points of damage! The bartender has 0 hit points
The bartender is defeated! He stands up and gives you his staff, "Nobody has defeated me in a long time. This is yours now."

>attack aframe
You attack AFrame, causing 5 points of damage! AFrame has 1000 hit points
AFrame attacks you, causing 7 points of damage! You have 10

* * *

>adf
Oh, adf eh!? I've heard a you.

Space Lounge
You are in the Space Lounge. It's dim and glowy all over with pulsating colors and subtle hypnotic sounds.

You can see an airlock, a black ninja outfit, a bar (on which are a Glowing Sphere and a glittery box (closed)), a bench, a comfy looking chair, a bartender, AFrame, and a securityBot here.

nothing

>e
(first opening the airlock)
As you enter the Veranda Walkway you see a floating dolphin surveillance pod.
Sweet, it seems like your ElectroMisdirector shielded you from detection. 

Veranda Walkway
Outside the Space Lounge you look out into the larger Raditree Building to see the pool under a high ceiling. Consuite lies beyond the pool in the main courtyard. Boffers beat each other up in the fenced in section of the courtyard. There's a floating platform above the pool.

You can see an airlock, a black rod, and a floating dolphin (closed) here.

You can go north, northeast, northwest, southeast, west through the airlock to the Space Lounge, up, and down from here.

>se
Upper Southside Hallway
This hallway is NUTS - there are signs everywhere and lights and sounds flashing. From this hallway you can get into a bunch of Party Rooms

You can go north, northeast, northwest to the Veranda Walkway, south, southeast, and southwest from here.

>se
Round1
Welcome to Trivia, I'm your host, a computer program super full of useless information. You will be rewarded with an object based on your score at the end of the quiz.

Wrong answers will not be rewarded with correct answers - I'm not telling you the right answer.

I have ONE singular accepted ABSOLUTELY CORRECT answer it's in a table and it is EXACT and PERFECT - I am the ULTIMATE IMPARTIAL QUIZ JUDGE. If you don't like it...cry me a spriver! OH also you are trapped within my quizzy embrace until the end so just accept your fate. Srsly don't try to leave or anything you'll just waste your answer-chances. The quiz is only four rounds of four questions each - just relax you're not stuck in a Quiz Vortex or anything...(I hope...)

Questions in the first round are worth 5 points a piece, but will increase in value as the game goes on.

Answers must be given with Capitalization and exact spelling.

-----------

The first section is on films involving simulated realities and questionable memories.

Who are you? Are you your memories? Are you what you have done? Are you what you will do? Or are you nothing at all but a wisp...or maybe "just" a program? 

You can go northwest to the Upper Southside Hallway from here.

In which movie did the main character die from super disturbing eye bulging decompression after helmet face plate breakage in the opening scene then but it turned out was just a dream? (or was it a premonition? or was it an implanted memory?)

Please enter your answer

* * *

>w
Space Lounge
You are in the Space Lounge. It's dim and glowy all over with pulsating colors and subtle hypnotic sounds.

You can see an airlock, a black ninja outfit, a bar (on which are a Glowing Sphere and a glittery box (closed)), a bench, a comfy looking chair, a bartender, AFrame, and a securityBot here.

You can go east through the airlock to the Veranda Walkway and west from here.

>e
As you enter the Veranda Walkway you see a floating dolphin surveillance pod.
Sweet it seems like your AdBlaster2000 shielded you from detection. 

Veranda Walkway
Outside the Space Lounge you look out into the larger Raditree Building to see the pool under a high ceiling. Consuite lies beyond the pool in the main courtyard. Boffers beat each other up in the fenced in section of the courtyard. There's a floating platform above the pool.

You can see an airlock, a black rod, and a floating dolphin (closed) here.

You can go north, northeast, northwest, southeast, west through the airlock to the Space Lounge, up, and down from here.

* * *

>adf
Oh, adf eh!? I've heard a you.

Space Lounge
You are in the Space Lounge. It's dim and glowy all over with pulsating colors and subtle hypnotic sounds.

You can see an airlock, a black ninja outfit, a bar (on which are a Glowing Sphere and a glittery box (closed)), a bench, a comfy looking chair, a bartender, AFrame, and a securityBot here.

nothing

>give coin to bartender
She accepts with a smile and slides you a smoothie. It looks friggin delicious.

>i
You are carrying: 
ShinyUnicorn
ElectroMisdirector
a message receiver
a dagger
(Health: 100)

>drink shinyunicorn
You quaff ShinyUnicorn. It goes down beautifully.

Secret Room
You are in the Secret Room. DON'T TELL ANYONE YOU WERE EVER HERE! It's really dark, you can't see much.

You can see a dolphin code and a book here.

You can see no obvious exits.

(There are no routes out of this room.)

* * *

>adf
Oh, adf eh!? I've heard a you.

Space Lounge
You are in the Space Lounge. It's dim and glowy all over with pulsating colors and subtle hypnotic sounds.

You can see an airlock, a black ninja outfit, a bar (on which are a Glowing Sphere and a glittery box (closed)), a bench, a comfy looking chair, a bartender, AFrame, and a securityBot here.

nothing

>go to Round1
You can't see any such thing.

>e
(first opening the airlock)
As you enter the Veranda Walkway you see a floating dolphin surveillance pod.
Sweet, it seems like your AdBlaster2000 shielded you from detection. 

Veranda Walkway
Outside the Space Lounge you look out into the larger Raditree Building to see the pool under a high ceiling. Consuite lies beyond the pool in the main courtyard. Boffers beat each other up in the fenced in section of the courtyard. There's a floating platform above the pool.

You can see an airlock, a black rod, and a floating dolphin (closed) here.

You can go north, northeast, northwest, southeast, west through the airlock to the Space Lounge, up, and down from here.

>se
Upper Southside Hallway
This hallway is NUTS - there are signs everywhere and lights and sounds flashing. From this hallway you can get into a bunch of Party Rooms

You can go north, northeast, northwest to the Veranda Walkway, south, southeast, and southwest from here.

>s
Staging Area
You can see a yellow jersey, a polkadot jersey, a green jersey, a white jersey, a blue jersey, DiscoWig, and ElectroMisdirector here.

You can go north to the Upper Southside Hallway from here.

>n
Upper Southside Hallway
This hallway is NUTS - there are signs everywhere and lights and sounds flashing. From this hallway you can get into a bunch of Party Rooms

You can go north, northeast, northwest to the Veranda Walkway, south to the Staging Area, southeast, and southwest from here.

>se
Round1
Welcome to Trivia, I'm your host, a computer program super full of useless information. You will be rewarded with an object based on your score at the end of the quiz.

Wrong answers will not be rewarded with correct answers - I'm not telling you the right answer.

I have ONE singular accepted ABSOLUTELY CORRECT answer it's in a table and it is EXACT and PERFECT - I am the ULTIMATE IMPARTIAL QUIZ JUDGE. If you don't like it...cry me a spriver! OH also you are trapped within my quizzy embrace until the end so just accept your fate. Srsly don't try to leave or anything you'll just waste your answer-chances. The quiz is only four rounds of four questions each - just relax you're not stuck in a Quiz Vortex or anything...(I hope...)

Questions in the first round are worth 5 points a piece, but will increase in value as the game goes on.

Answers must be given with Capitalization and exact spelling.

-----------

The first section is on films involving simulated realities and questionable memories.

Who are you? Are you your memories? Are you what you have done? Are you what you will do? Or are you nothing at all but a wisp...or maybe "just" a program? 

You can go northwest to the Upper Southside Hallway from here.

This movie has a sail boat smash into the end of a fake world. Everyone watching just goes totally nuts.

Please enter your answer

>The Truman Show
Well done.  Next question.

This film has annoying gothy villians but a super cool reveal that everyone was in a giant space habitat the WHOLE TIME?! (btw foreshadowing...)

Please enter your answer

>Dark City
Well done.  Next question.

In which film did someone get offered a choice between two pills and then didn't take both of them like they should have?

Please enter your answer

>The Matrix
Well done.  Next question.

In which movie did the main character die from super disturbing eye bulging decompression after helmet face plate breakage in the opening scene then but it turned out was just a dream? (or was it a premonition? or was it an implanted memory?)

Please enter your answer

>Total Recall
That was Round One, now onto Round Two!

Round2
Now onto Round Two where the questions are worth ten points a piece. The subject of this round is Interactive Fiction! M(meta)E(meta)T(meta)A

You can see no obvious exits.

This Apple II game features a game play element where the player is given a three-digit code at the beginning of play and is instructed to never reveal this code to anyone. At one point the game appears to crash as a way of tricking the player into revealing their code, in which case they lose the game. What is the name of this game?

Please enter your answer

>Zork
Incorrect. Next question.

Colossal Cave Adventure featured a "magic word" that caused teleportation and has shown up again and again in video games ever since.  It enables cheat modes, opens Easter Eggs and has inspired many silly programs. Type this magic word in lowercase now.

Please enter your answer

>xyzzy
Well done.  Next question.

Around 1975, a programmer and amateur caver wrote the first text adventure game whose name originally was all caps and only six characters long because of filename length limitations of that time. What is the name of this game (the all-caps six letter version)

Please enter your answer

>ADVENT
Well done.  Next question.

In what game series are you likely to be eaten by a grue if you travel into dark places without a light source?

Please enter your answer

>Zork
That was Round Two, now onto Round Three where things get a bit more difficult!

Round3
Round Three is here! The questions are harder but now worth fifteen points a piece. These ones are about going INSIDE THE COMPUTER!

You can see no obvious exits.

Who is the actor who played the program Crom in Tron - you might also know him as Londo...

Please enter your answer

>df
Incorrect. Next question.

This character started out as a real-life-human-reporter but after someone tried to kill him he ended up in a coma and then got his mind uploaded TO A COMPUTER. The transition altered his personality forever.

Please enter your answer

>Max Headroom
Well done.  Next question.

What is the name of the anime about a VRMMORPG where the players have to play until they either die or someone beats the game? No logging out. WHAAaaaa? Wicked eh?

Please enter your answer

>Sword Art Online
Well done.  Next question.

This 1980"s movie about Virtual Reality was such garbage that it basically halted research and tech development in VR for about 20 years.

Please enter your answer

>The Lawnmower Man
That was Round Three, now onto Round Four!

Round4
This is it, the final round. You're so close to escaping this quiz that not even a Quiz Vortex could keep you from exiting the quiz-field. The questions are worth twenty points a piece.

This round is about choices, random forces and what they lead to...which is of course PARALLEL UNIVERSES!

Every imagined-not-taken choice spawned from every individual's mind throughout time and space creating entire universes with every passing thought. The vast sea of thought embracing the infinite seeds of thought; the birth of what-ifs reflecting infinitely. 

You can see no obvious exits.

Who wrote The Coming of the Quantum Cats, which includes a parallel universe prison planet, and a triad -relationship including three different versions of the same person? (OMG that is so hawt!)

Please enter your answer

>Frederick Pohl
Incorrect. Next question.

Who wrote a series of stories about children travelling between parallel worlds with a powerful knife, and has book titles inspired by Paradise Lost?

Please enter your answer

>sdf
Incorrect. Next question.

What movie about parallel universes involves a good version of Jet Li trying to stop an evil version of Jet Li who is determined to gain ultimate power by being the only version of himself throughout all universes?

Please enter your answer

>TheOne
Incorrect. Next question.

What is the name of the author who wrote about Sir Luther of Arkwright - a hero who can travel through the parallels at will?

Please enter your answer

>Brian Talbot
Incorrect. That was the end of Round Four.

End
Final Score: 95/200

You can go northeast to the Upper Southside Hallway from here.

>ne
Upper Southside Hallway
This hallway is NUTS - there are signs everywhere and lights and sounds flashing. From this hallway you can get into a bunch of Party Rooms

You can go north, northeast, northwest to the Veranda Walkway, south to the Staging Area, southeast to the Round1, and southwest to the End from here.

[Your score has just gone up by ninety-five points.]

* * *

>adf
Oh, adf eh!? I've heard a you.

Space Lounge
You are in the Space Lounge. It's dim and glowy all over with pulsating colors and subtle hypnotic sounds.

You can see an airlock, a black ninja outfit, a bar (on which are a Glowing Sphere and a glittery box (closed)), a bench, a comfy looking chair, a bartender, AFrame, and a securityBot here.

nothing

>i
You are carrying: 
ElectroMisdirector
a message receiver
a coin
a dagger
(Health: 100)

>e
(first opening the airlock)

Veranda Walkway
Outside the Space Lounge you look out into the larger Raditree Building to see the pool under a high ceiling. Consuite lies beyond the pool in the main courtyard. Boffers beat each other up in the fenced in section of the courtyard. A floating dolphin surveillance pod floats by making you twitch instintively to make your shiny wig come between the camera and your face.

You can see an airlock, a black rod, and a floating dolphin (closed) here.

You can go north, northeast, northwest, southeast, west through the airlock to the Space Lounge, up, and down from here.

(From here, you can move to north, northeast, northwest, southeast, west, up, and down.)

>se
Upper Southside Hallway
This hallway is NUTS - there are signs everywhere and lights and sounds flashing. From this hallway you can get into a bunch of Party Rooms

You can go north, northeast, northwest to the Veranda Walkway, south, southeast, and southwest from here.

(From here, you can move to north, northeast, northwest, south, southeast, and southwest.)

>s
Staging Area
You can see a polkadot jersey, a green jersey, a white jersey, a blue jersey, and discowig here.

You can go north to the Upper Southside Hallway from here.

(From here, you can move to north.)

>look discowig
discowig

* * *

>i
You are carrying: 
ElectroMisdirector
a message receiver
a coin
a dagger
(Health: 100)

>look electromisdirector
A small device shaped like a horseshoe worn as a hat that misdirects any light coming towards your face upward. Kinda makes it look like you have no head. Totally legal (as long as you have the licensure information correctly processed of course). (Which you don't.)

>give coin to bartender
She accepts with a smile and slides you a smoothie. It looks friggin delicious.

>i
You are carrying: 
a blah
ElectroMisdirector
a message receiver
a dagger
(Health: 100)

>look smoothie
You can't see any such thing.

>take smoothie
You can't see any such thing.

>i
You are carrying: 
a blah
ElectroMisdirector
a message receiver
a dagger
(Health: 100)

>look blah
This thing is like taking a bath in frozen unicorn snot. Amazing.

* * *

>i
You are carrying: 
ElectroMisdirector
a message receiver
a coin
a dagger
(Health: 100)

>look polkadot jersey
Since 1933, the Tour de France has awarded this jersey to the King of the Mountains.

* * *

>adf
Oh, adf eh!? I've heard a you.

Space Lounge
You are in the Space Lounge. It's dim and glowy all over with pulsating colors and subtle hypnotic sounds.

You can see an airlock, a black ninja outfit, a bar (on which are a Glowing Sphere and a glittery box (closed)), a bench, a comfy looking chair, a bartender, AFrame, and a securityBot here.

nothing

>look
Space Lounge
You are in the Space Lounge. It's dim and glowy all over with pulsating colors and subtle hypnotic sounds.

You can see an airlock, a black ninja outfit, a bar (on which are a Glowing Sphere and a glittery box (closed)), a bench, a comfy looking chair, a bartender, AFrame, and a securityBot here.

>look
Space Lounge
You are in the Space Lounge. It's dim and glowy all over with pulsating colors and subtle hypnotic sounds.

You can see an airlock, a black ninja outfit, a bar (on which are a Glowing Sphere and a glittery box (closed)), a bench, a comfy looking chair, a bartender, AFrame, and a securityBot here.

>sit on chair
Oh boy this chair looks really soft and comfy! Ooooh ya you are totally gonna sit on this chair big time.

You get onto the comfy looking chair.

on the comfy chair

>look
Space Lounge (on the comfy looking chair)
You are in the Space Lounge. It's dim and glowy all over with pulsating colors and subtle hypnotic sounds.

You can see an airlock, a black ninja outfit, a bar (on which are a Glowing Sphere and a glittery box (closed)), a bench, a bartender, AFrame, and a securityBot here.

on the comfy chair

* * *

>adf
Oh, adf eh!? I've heard a you.

Space Lounge
You are in the Space Lounge. It's dim and glowy all over with pulsating colors and subtle hypnotic sounds.

You can see an airlock, a black ninja outfit, a bar (on which are a Glowing Sphere and a glittery box (closed)), a bench, a comfy looking chair, a bartender, AFrame, and a securityBot here.

nothing

>look bar
The bar is kind of an average looking bar.

On the bar are a Glowing Sphere and a glittery box (closed).

* * *

>adf
Oh, adf eh!? I've heard a you.

Space Lounge
You are in the Space Lounge. It's dim and glowy all over with pulsating colors and subtle hypnotic sounds.

You can see an airlock, a black ninja outfit, a bar (on which are a Glowing Sphere and a glittery box (closed)), a bench, a comfy looking chair, a bartender, AFrame, and a securityBot here.

nothing

>se
You can't go that way.

>se
You can't go that way.

>e
(first opening the airlock)

Veranda Walkway
Outside the Space Lounge you look out into the larger Raditree Building to see the pool under a high ceiling. Consuite lies beyond the pool in the main courtyard. Boffers beat each other up in the fenced in section of the courtyard. A floating dolphin surveillance pod floats by making you twitch instintively to make your shiny wig come between the camera and your face.

You can see an airlock, a black rod, and a floating dolphin (closed) here.

You can go north, northeast, northwest, southeast, west through the airlock to the Space Lounge, up, and down from here.

(From here, you can move to north, northeast, northwest, southeast, west, up, and down.)

* * *

>se
Upper Southside Hallway
This hallway is NUTS - there are signs everywhere and lights and sounds flashing. From this hallway you can get into a bunch of Party Rooms

You can go north, northeast, northwest to the Veranda Walkway, south, southeast, and southwest from here.

(From here, you can move to north, northeast, northwest, south, southeast, and southwest.)

>s
Staging Area
You can see a yellow jersey, a polkadot jersey, a white jersey, a blue jersey, DiscoWig, ElectroMisdirector, and AdBlaster2000 here.

You can go north to the Upper Southside Hallway from here.

(From here, you can move to north.)

>look discowig
This wig is all sproingy and is made of tons of tiny pieces of holographic metallic rainbow shards. As you move about the light around you is refracted into a million directions, making face recog almost impossible.

>l electro
You can't see any such thing.

>l electromisdirector
A small device shaped like a horseshoe worn as a hat that misdirects any light coming towards your face upward. Kinda makes it look like you have no head. Totally legal (as long as you have the licensure information correctly processed of course). (Which you don't.)

>l adblaster
A little robot that follows you around projecting fragmented images of the Yummy Little Fingers Yum Yum Brand (hereby licensed). Effectively shrouds your own identity by covering it with constantly moving Little Fingers ads. It is kind of annoying for anyone you try to talk to though. (Tends to make people hungry).

* * *

>adf
Oh, adf eh!? I've heard a you.

Space Lounge
You are in the Space Lounge. It's dim and glowy all over with pulsating colors and subtle hypnotic sounds.

You can see an airlock, a black ninja outfit, a bar (on which are a Glowing Sphere and a glittery box (closed)), a bench, a comfy looking chair, a bartender, AFrame, and a securityBot here.

nothing

>securityBot, take coinc
There is no reply.

>securityBot, take coin
The securityBot looks pissed. Maybe you outta not mess with securityBots...

>securityBot, take dagger
The securityBot looks pissed. Maybe you outta not mess with securityBots...

* * *

>adf
Oh, adf eh!? I've heard a you.

Space Lounge
You are in the Space Lounge. It's dim and glowy all over with pulsating colors and subtle hypnotic sounds.

You can see an airlock, a black ninja outfit, a bar (on which are a Glowing Sphere and a glittery box (closed)), a bench, a comfy looking chair, a bartender, AFrame, and a securityBot here.

nothing

>sit on chair
Oh boy this chair looks really soft and comfy! Ooooh ya you are totally gonna sit on this chair big time.

You get onto the comfy looking chair.

on the comfy chair

* * *

>adfs
adfs!? Har har har! Musta been one-a them vat babies huh?

Space Lounge
You are in the Space Lounge. It's dim and glowy all over with pulsating colors and subtle hypnotic sounds.

You can see an airlock, a black ninja outfit, a bar (on which are a Glowing Sphere and a glittery box (closed)), a bench, a comfy looking chair, a bartender, AFrame, and a securityBot here.

You can go east through the airlock (closed) and west from here.

>e
(first opening the airlock)
You are wearing a DiscoWig.

>i
You're carrying a message receiver, a coin, and a dagger. You're wearing DiscoWig.

* * *

>adfs
adfs!? Har har har! Musta been one-a them vat babies huh?

Space Lounge
You are in the Space Lounge. It's dim and glowy all over with pulsating colors and subtle hypnotic sounds.

You can see an airlock, a black ninja outfit, a bar (on which are a Glowing Sphere and a glittery box (closed)), a bench, a comfy looking chair, a bartender, AFrame, and a securityBot here.

You can go east through the airlock (closed) and west from here.

>open box
You open the glittery box, revealing a securityReadout, a bowl, and a crazy looking gun.

* * *

>take gun
You have no idea what this gun does. You've never seen anything like it! You're pretty stoked to get this gun.

Taken.

>shoot sphere with gun
ZAP! The Glowing Sphere twinkles out of existence! The securityKey clatters to the ground!

>shoot Aframe
(with the crazy looking gun)
This weird ray comes out of your gun but it's like it's moving in slow-motion...as the beam wiggles toward Aframe super duper slow he steps out of the way of it. The wiggling intensifies and disappears. Aframe is looking at you with this annoyed look. Like he doesn't totally trust you anymore because you just tried to twinkle him out of existence.

>look dagger
The dagger is kind of an average looking dagger.

>hit Aframe with dagger
I only understood you as far as wanting to hit AFrame.

>stab Aframe with dagger
I didn't understand that sentence.

>attack Aframe
Violence isn't the answer to this one.

* * *

>ads
ads!? Har har har! Musta been one-a them vat babies huh?

Space Lounge
You are in the Space Lounge. It's dim and glowy all over with pulsating colors and subtle hypnotic sounds.

You can see an airlock, a black ninja outfit, a bar (on which are a Glowing Sphere and a glittery box (closed)), a bench, a chair, a bartender, AFrame, and a Security bot here.

You can go east through the airlock (closed) and west from here.

(From here, you can move to east and west.)

>e
(first opening the airlock)
As you enter the Veranda Walkway you see a floating dolphin surveillance pod.
Sweet it seems like your AdBlaster2000 shielded you from detection. 

Veranda Walkway
Outside the Space Lounge you look out into the larger Raditree Building to see the pool under a high ceiling. Consuite lies beyond the pool in the main courtyard. Boffers beat each other up in the fenced in section of the courtyard.

You can see an airlock, a black rod, and a floating dolphin (closed) here.

You can go north, northeast, northwest, southeast, west through the airlock to the Space Lounge, up, and down from here.

(From here, you can move to north, northeast, northwest, southeast, west, up, and down.)

* * *

>asdf
Incorrect. Next question.

This film has annoying gothy villians but a super cool reveal that everyone was in a giant space habitat the WHOLE TIME?! (btw foreshadowing...)

Please enter your answer

>sdf
Incorrect. Next question.

This movie has a sail boat smash into the end of a fake world. Everyone watching just goes totally nuts.

Please enter your answer

>asfd
Incorrect. Next question.

In which film did someone get offered a choice between two pills and then didn't take both of them like they should have?

Please enter your answer

>fsda
That was Round One, now onto Round Two!

Round2
Now onto Round Two where the questions get slightly harder but are worth ten points a piece.

You can see no obvious exits.

(There are no routes out of this room.)

Get a Mac was an ad slogan for what company from 2006 to 2009? 

Please enter your answer

>fds
That was Round Two, now onto Round Three!

Round3
Round Three is here! The questions are harder but now worth fifteen points a piece. These ones are about going INSIDE THE COMPUTER!

You can see no obvious exits.

(There are no routes out of this room.)

Ebony and Ivory was a duet performed by Stevie Wonder and what former Beatle?

Please enter your answer

>asfd
That was Round Three, now onto Round Four!

Round4
This is it, the final round. You're so close to escaping this quiz that not even a Quiz Vortex could keep you from exiting the quiz-field. The questions are worth twenty points a piece.

This round is about choices, random forces and what they lead to...which is of course PARALLEL UNIVERSES!

Every imagined-not-taken choice spawned from every individual's mind throughout time and space creating entire universes with every passing thought. The vast sea of thought embracing the infinite seeds of thought; the birth of what-ifs reflecting infinitely. 

You can see no obvious exits.

(There are no routes out of this room.)

What movie about parallel universes involves a good version of Jet Li trying to stop an evil version of Jet Li who is determined to gain ultimate power by being the only version of himself throughout all universes?

Please enter your answer

>asdf
Incorrect. Next question.

Who wrote The Coming of the Quantam Cats, which includes a parallel universe prison planet, and a triad -relationship including three different versions of the same person? (OMG that is so hawt! I'd be super gay for me fershure-can_you-imagine!?)

Please enter your answer

* * *

>adsf
Oh, adsf eh!? I've heard a you.

Space Lounge
You are in the Space Lounge. It's dim and glowy all over with pulsating colors and subtle hypnotic sounds.

You can see an airlock, a black ninja outfit, a bar (on which are a Glowing Sphere and a glittery box (closed)), a bench, a comfy looking chair, a bartender, AFrame, and a securityBot here.

You can go east through the airlock (closed) and west from here.

>attack aframe
You attack AFrame, causing 5 points of damage! AFrame has 995 hit points
AFrame attacks you, causing 2 points of damage! You have 8 hit points

>attack bartender
You attack the bartender, causing 6 points of damage! The bartender has -6 hit pointsyou can't attack this being

* * *

>adsf
Oh, adsf eh!? I've heard a you.

Space Lounge
You are in the Space Lounge. It's dim and glowy all over with pulsating colors and subtle hypnotic sounds.

You can see an airlock, a black ninja outfit, a bar (on which are a Glowing Sphere and a glittery box (closed)), a bench, a comfy looking chair, a bartender, AFrame, and a securityBot here.

You can go east through the airlock (closed) and west from here.

>e
(first opening the airlock)
As you enter the Veranda Walkway you see a floating dolphin surveillance pod.
Sweet it seems like your DiscoWig shielded you from detection. 

Veranda Walkway
Outside the Space Lounge you look out into the larger Raditree Building to see the pool under a high ceiling. Consuite lies beyond the pool in the main courtyard. Boffers beat each other up in the fenced in section of the courtyard.

You can see an airlock, a black rod, and a floating dolphin (closed) here.

You can go north, northeast, northwest, southeast, west through the airlock to the Space Lounge, up, and down from here.

(From here, you can move to nothing.)

>e
You can't go that way.

>se
Upper Southside Hallway
This hallway is NUTS - there are signs everywhere and lights and sounds flashing. From this hallway you can get into a bunch of Party Rooms

You can go north, northeast, northwest to the Veranda Walkway, south, southeast, and southwest from here.

(From here, you can move to north, northeast, northwest, south, southeast, and southwest.)

>nw
Veranda Walkway
Outside the Space Lounge you look out into the larger Raditree Building to see the pool under a high ceiling. Consuite lies beyond the pool in the main courtyard. Boffers beat each other up in the fenced in section of the courtyard.

You can see an airlock, a black rod, and a floating dolphin (closed) here.

You can go north, northeast, northwest, southeast to the Upper Southside Hallway, west through the airlock to the Space Lounge, up, and down from here.

(From here, you can move to north, northeast, northwest, southeast, west, up, and down.)

* * *

>adsf
Oh, adsf eh!? I've heard a you.

Space Lounge
You are in the Space Lounge. It's dim and glowy all over with pulsating colors and subtle hypnotic sounds.

You can see an airlock, a black ninja outfit, a bar (on which are a Glowing Sphere and a glittery box (closed)), a bench, a comfy looking chair, a bartender, AFrame, and a securityBot here.

You can go east through the airlock (closed) and west from here.

>open box
You open the glittery box, revealing a security readout, a bowl, and a crazy looking gun.

>take gun
You have no idea what this gun does. You've never seen anything like it! You're pretty stoked to get this gun.

Taken.

>shoot gun
What do you want to shoot the crazy looking gun at?

>shoot gun at bar
Uhm are you nuts? You don't even know what this gun thing does and besides if you draw too much attention to yourself you'll be swarmed by security in seconds. It's probably out of batteries anyway. In a pinch you might be able to use it to scare the crap out of someone though, this gun is so crazy looking anyone would do anything rather than get shot by something like it.

>shoot sphere
(with the crazy looking gun)
Uhm are you nuts? You don't even know what this gun thing does and besides if you draw too much attention to yourself you'll be swarmed by security in seconds. It's probably out of batteries anyway. In a pinch you might be able to use it to scare the crap out of someone though, this gun is so crazy looking anyone would do anything rather than get shot by something like it.

* * *

>adsf
Oh, adsf eh!? I've heard a you.

Space Lounge
You are in the Space Lounge. It's dim and glowy all over with pulsating colors and subtle hypnotic sounds.

You can see an airlock, a black ninja outfit, a bar (on which are a Glowing Sphere and a glittery box (closed)), a bench, a comfy looking chair, a bartender, AFrame, and a securityBot here.

You can go east through the airlock (closed) and west from here.

>securityBot, take coin
The securityBot looks pissed. Maybe you outta not mess with securityBots...
1

>securityBot, take coin
The securityBot looks pissed. Maybe you outta not mess with securityBots...
2

>securityBot, take coin
The securityBot looks pissed. Maybe you outta not mess with securityBots...
2

* * *

>adsf
Oh, adsf eh!? I've heard a you.

Space Lounge
You are in the Space Lounge. It's dim and glowy all over with pulsating colors and subtle hypnotic sounds.

You can see an airlock, a black ninja outfit, a bar (on which are a Glowing Sphere and a glittery box (closed)), a bench, a comfy looking chair, a bartender, AFrame, and a securityBot here.

You can go east through the airlock (closed) and west from here.

>sit on chair
Oh boy this chair looks really soft and comfy! Ooooh ya you are totally gonna sit on this chair big time.

You get onto the comfy looking chair.

on the comfy chair

>sit on chair
Oh boy this chair looks really soft and comfy! Ooooh ya you are totally gonna sit on this chair big time.

"Hey Wait!" your subconscious jumps forth remembering the tempting softness - you decide not not to sit on that comfy looking chair, it's so comfy you might never get up again! It looks seriously comfy though...maybe just for a little tiny sliver of a moment you could get kinda comfy...

on a soft thing

>sit on chair
Oh boy this chair looks really soft and comfy! Ooooh ya you are totally gonna sit on this chair big time.

Don't you remember the last time you were in that comfy looking chair? It almost ATE YOU! What is your deal? Don't sit in this comfy looking chair, it's too dangerous! Only a master of mental projection could sit on this comfy looking chair without its super soft comfy-ness obliterating and subsuming your soul to its dark comfy desires.

on a soft thing 3

>sit on chair
Oh boy this chair looks really soft and comfy! Ooooh ya you are totally gonna sit on this chair big time.

    *** You sit on the chair again and sink forever into its comfyness. You never rise again. ***

In that game you scored 0 out of a possible 0, in 4 turns.

Would you like to RESTART, RESTORE a saved game, QUIT, or UNDO the last command?

* * *

>afd
afd? Interesting, nice.

Space Lounge
You are in the Space Lounge. It's dim and glowy all over with pulsating colors and subtle hypnotic sounds.

You can see an airlock, a black ninja outfit, a bar (on which are a Glowing Sphere and a glittery box (closed)), a bench, a chair, a bartender, AFrame, and a Security bot here.

You can go east through the airlock (closed) and west from here.

(From here, you can move to east and west.)

>w
BehindtheBar
You shouldn't be here, it's behind the bar.

You can see ShinyUnicorn here.

You can go east to the Space Lounge from here.

(From here, you can move to east.)

* * *

>aframe
aframe!? Aaaah, that's a good one.

Space Lounge
You are in the Space Lounge. It's dim and glowy all over with pulsating colors and subtle hypnotic sounds.

You can see an airlock, a black ninja outfit, a bar (on which are a Glowing Sphere and a glittery box (closed)), a bench, a comfy looking chair, a bartender, AFrame, and a securityBot here.

You can go east through the airlock (closed) and west from here.

>open box
You open the glittery box, revealing a securityReadout, a bowl, and a crazy looking gun.

>talk bot
I didn't understand that sentence.

>talk securityBot
I didn't understand that sentence.

>talk to securityBot
You say hello to the securityBot.

>take gun
You have no idea what this gun does. You've never seen anything like it! You're pretty stoked to get this gun.

Taken.

>shoot gun
What do you want to shoot the crazy looking gun with?

>look
Space Lounge
You are in the Space Lounge. It's dim and glowy all over with pulsating colors and subtle hypnotic sounds.

You can see an airlock, a black ninja outfit, a bar (on which are a Glowing Sphere and a glittery box (in which are a securityReadout and a bowl (in which is a note))), a bench, a comfy looking chair, a bartender, AFrame, and a securityBot here.

You can go east through the airlock (closed) and west from here.

I beg your pardon?

>shoot sphere with gun
You need a projectile weapon to shoot anything.

* * *

>aframe remove suit
That's not a verb I recognize.

>aframe, remove suit
AFrame takes off the pin-striped suit.

>take gun
You can't see any such thing.

>open box
You open the glittery box, revealing a security readout, a bowl, and a crazy looking gun.

* * *

>take gun
You have no idea what this gun does. You've never seen anything like it! You're pretty stoked to get this gun.

Taken.

>shoot aframe with gun
ZAP! AFrame twinkles out of existence!

* * *

>aframe, remove suit
He says "sure, anything for a laugh!"
AFrame takes off the pin-striped suit.

>look aframe
Aframe leans on a polystyrene pillar, wearing a pink thong with his usual aplomb.

>aframe, remove thong
AFrame takes off the pink thong.

>look
Space Lounge
You are in the Space Lounge, rumored to be the center of The Resistance. "Why did I come here?" you briefly wonder before looking around.

You can see an airlock, a bar (on which are a glittery box (closed) and a Glowing Sphere), a chair, a bench, a bartender, a black ninja outfit, and AFrame here.

You can go east through the airlock (closed) from here.

(From here, you can move to east.)

>look aframe
Aframe leans on a polystyrene pillar, wearing nothing with his usual aplomb.

>aframe put on thong
That's not a verb I recognize.

>aframe, wear thing
There is no reply.

>aframe, wear thong
AFrame puts on the pink thong.

>aframe, wear suit
AFrame puts on the pin-striped suit.

>look aframe
Aframe leans on a polystyrene pillar, wearing a pin-striped suit with his usual aplomb.

>talk aframe
That's not a verb I recognize.

>look
Space Lounge
You are in the Space Lounge, rumored to be the center of The Resistance. "Why did I come here?" you briefly wonder before looking around.

You can see an airlock, a bar (on which are a glittery box (closed) and a Glowing Sphere), a chair, a bench, a bartender, a black ninja outfit, and AFrame here.

You can go east through the airlock (closed) from here.

(From here, you can move to east.)

>e
(first opening the airlock)
(first unlocking the airlock)
You lack a key that fits the airlock.

* * *

>aframe, remove suit
He says "sure, anything for a laugh!"
AFrame takes off the pin-striped suit.

>open box
You open the glittery box, revealing a security readout, a bowl, and a crazy looking gun.

* * *

>take gun
You have no idea what this gun does. You've never seen anything like it! You're pretty stoked to get this gun.

Taken.

>shoot aframe
(with the crazy looking gun)
This weird ray comes out of your gun but it's like it's moving in slow-motion...as the beam wiggles toward Aframe super duper slow he steps out of the way of it. The wiggling intensifies and disappears. Aframe is looking at you with this annoyed look. Like he doesn't totally trust you anymore because you just tried to twinkle him out of existence.

>aframe, remove thong
He says "uhm I am not going to help you out because in case you forgot you tried to kill me. I don't even know why"

>ask aframe about xx
When you mention xx, Aframe's eyes light up. He smiles and looks around the room for a second before stepping closer to you. "How do you know aobut xx?", he says - well it doesn't matter now - just remember yy when you get to the zz okay? DON'T FORGET ABOUT THE YY! Then he looks around again and slowly fades from view, like all the color faded to grey, then all the outlines of his features just slowly alpha-faded to zero.

>look aframe
You can't see any such thing.

>e
(first opening the airlock)

Veranda Walkway
Outside the Space Lounge you look out into the larger Raditree Building to see the pool with under a high ceiling. Consuite lies beyond the pool in the main courtyard. Boffers beat each other up in the fenced in section of the courtyard. A floating dolphin surveillance pod floats by making you twitch instintively to make your shiny wig come between the camera and your face.

You can see an airlock, a black rod, and a floating dolphin (closed) here.

You can go north, northeast, northwest, southeast, west through the airlock to the Space Lounge, up, and down from here.

(From here, you can move to north, northeast, northwest, southeast, west, up, and down.)

>take rod
Taken.

>xyyxz
That's not a verb I recognize.

>w
Space Lounge
You are in the Space Lounge, rumored to be the center of The Resistance. "Why did I come here?" you briefly wonder before looking around.

You can see an airlock, a bar (on which are a glittery box (in which are a security readout and a bowl (in which is a note)) and a Glowing Sphere), a chair, a bench, a bartender, a black ninja outfit, and a Security bot here.

You can go east through the airlock to the Veranda Walkway from here.

(From here, you can move to east.)

>take note
Taken.

>read note
Cast the secret spell xyzzy

>cast xyzzy
you feel a whooshy sound enter your eyeball sockets and then your tummy flips over your groiny-place. WHOOOOOAAAA suddenly you find yourself trasported to the...

you feel a whooshy sound enter your eyeball sockets and then your tummy flips over your groiny-place. WHOOOOOAAAA suddenly you find yourself trasported to the...

Secret Room
You are in the Secret Room. DON'T TELL ANYONE YOU WERE EVER HERE! It's really dark, you can't see much.

You can see AFrame, a dolphin code, and a book here.

You can see no obvious exits.

(There are no routes out of this room.)

Under the influence of the black rod, you pronounced "xyzzy" as Xhi-zee. You understand now that the purpose of the black rod is to bring people here, to the Secret Room.

>look aframe
Aframe leans on a polystyrene pillar, wearing a pink thong with his usual aplomb.

>aframe, remove thong
He gives this double-wink thing - like winking with one eye twice then the other once then both at the same time then rolls his eyes up then blinks both eyes again. That's the secret code you know cause you're buds.
AFrame takes off the pink thong.

* * *

>aframe, take off suit
He says "sure, anything for a laugh!"
AFrame takes off the pin-striped suit.

>open box
You open the glittery box, revealing a security readout, a bowl, and a crazy looking gun.

* * *

>shoot aframe
(with the crazy looking gun)
This weird ray comes out of your gun but it's like it's moving in slow-motion...as the beam wiggles toward Aframe super duper slow he steps out of the way of it. The wiggling intensifies and disappears. Aframe is looking at you with this annoyed look. Like he doesn't totally trust you anymore because you just tried to twinkle him out of existence.

>aframe, take off thong
He says "uhm I am not going to help you out because in case you forgot you tried to kill me. I don't even know why"

>aframe xyzzy
I didn't understand that sentence.

>aframe, xx
There is no reply.

>ask aframe about xx
When you mention xx, Aframe's eyes light up. He smiles and looks around the room for a second before stepping closer to you. "How do you know aobut xx?", he says - well it doesn't matter now - just remember yy when you get to the zz okay? DON'T FORGET ABOUT THE YY! Then he looks around again and slowly fades from view, like all the color faded to grey, then all the outlines of his features just slowly alpha-fade to zero.

>aframe take off thong
I didn't understand that sentence.

* * *

>agent spacebug
Oh agent spacebug eh!? I've heard a you.

Space Lounge
You are in the Space Lounge. It's dim and glowy all over with pulsating colors and subtle hypnotic sounds.

You can see an airlock, a black ninja outfit, a bar (on which are a Glowing Sphere and a glittery box (closed)), a bench, a chair, a bartender, AFrame, and a Security bot here.

You can go east through the airlock (closed) and west from here.

(From here, you can move to east and west.)

>i
You are carrying: 
AdBlaster2000
a message receiver
a coin
a dagger
(Health: 100)

>look AdBlaster2000
A little robot that follows you around projecting fragmented images of the Yummy Little Fingers Yum Yum Brand (hereby licensed). Effectively shrouds your own identity by covering it with constantly moving Little Fingers ads. It is kind of annoying for anyone you try to talk to though. (Tends to make people hungry).

>look message receiver
Dear agent, 

You really should meet me tonight in the Space Lounge...you're gonna be pumped! -AFrame

>give coin to bartender
She accepts with a smile and slides you a smoothie. It looks friggin delicious.

>drink smoothie
You can't see any such thing.

>i
You are carrying: 
ShinyUnicorn
AdBlaster2000
a message receiver
a dagger
(Health: 100)

>look shinyunicorn
This thing is like taking a bath in frozen unicorn snot. Amazing.

>drink smoothie
You can't see any such thing.

>drink shinyunicorn
You quaff ShinyUnicorn. It goes down beautifully.

Floating Courtyard
This is amazing - you are up above everything and can see so much up here! There's a pool down below, and a fenced in courtyard with some kind of security gate system surrounding it, and Consuite.

You can go down from here.

(From here, you can move to down.)

* * *

>asd
asd!? Har har har! Musta been one-a them vat babies huh?

Space Lounge
You are in the Space Lounge. It's dim and glowy all over with pulsating colors and subtle hypnotic sounds.

You can see an airlock, a black ninja outfit, a bar (on which are a Glowing Sphere and a glittery box (closed)), a bench, a comfy looking chair, a bartender, AFrame, and a securityBot here.

You can go east through the airlock (closed) and west from here.

>ask bartender about AFrame
There is no reply.

>hello bartender
I only understood you as far as wanting to hello.

>say hello to bartender
You are already talking to the bartender.

>hi
You are already talking to the bartender.

>hey
I didn't understand that sentence.

>hi
You are already talking to the bartender.

>ask Aframe about xx
When you mention xx, Aframe's eyes light up. He smiles and looks around the room for a second before stepping closer to you. "How do you know aobut xx?", he says - well it doesn't matter now - just remember yy when you get to the zz okay? DON'T FORGET ABOUT THE YY! Then he looks around again and slowly fades from view, like all the color faded to grey, then all the outlines of his features just slowly alpha-fade to zero.

>give coin to bartender
She accepts with a smile and slides you a smoothie. It looks friggin delicious.

>look smoothie
You can't see any such thing.

>inv
You're carrying thisas, a message receiver, and a dagger. You're wearing DiscoWig.

>look bar
The bar is kind of unremarkable, not really exciting like some cool crazy gun would be or something.

On the bar are a Glowing Sphere and a glittery box (closed).

* * *

>asd
asd!? Har har har! Musta been one-a them vat babies huh?

Space Lounge
You are in the Space Lounge. It's dim and glowy all over with pulsating colors and subtle hypnotic sounds.

You can see an airlock, a black ninja outfit, a bar (on which are a Glowing Sphere and a glittery box (closed)), a bench, a comfy looking chair, a bartender, AFrame, and a securityBot here.

You can go east through the airlock (closed) and west from here.

>attack aframe
You attack AFrame, causing 10 points of damage! AFrame has 1000
AFrame attacks you, causing 5 points of damage! You have

>attack aframe
You attack AFrame, causing 10 points of damage! AFrame has 990
AFrame attacks you, causing 5 points of damage! You have

>attack aframe
You attack AFrame, causing 10 points of damage! AFrame has 980
AFrame attacks you, causing 6 points of damage! You have
You die in battle, like a warrior!

    *** The End ***

In that game you scored 0 out of a possible 0, in 3 turns.

Would you like to RESTART, RESTORE a saved game, QUIT, or UNDO the last command?

* * *

>asd
asd!? Har har har! Musta been one-a them vat babies huh?

Space Lounge
You are in the Space Lounge. It's dim and glowy all over with pulsating colors and subtle hypnotic sounds.

You can see an airlock, a black ninja outfit, a bar (on which are a Glowing Sphere and a glittery box (closed)), a bench, a comfy looking chair, a bartender, AFrame, and a securityBot here.

You can go east through the airlock (closed) and west from here.

>give coin to bartender
She accepts with a smile and slides you a smoothie. It looks friggin delicious.

>i
You are carrying: 
RocketBlaster
DiscoWig
a message receiver
a dagger
(Health: 100)

* * *

>asd
asd!? Har har har! Musta been one-a them vat babies huh?

Space Lounge
You are in the Space Lounge. It's dim and glowy all over with pulsating colors and subtle hypnotic sounds.

You can see an airlock, a black ninja outfit, a bar (on which are a Glowing Sphere and a glittery box (closed)), a bench, a comfy looking chair, a bartender, AFrame, and a securityBot here.

You can go east through the airlock (closed) and west from here.

>look
Space Lounge
You are in the Space Lounge. It's dim and glowy all over with pulsating colors and subtle hypnotic sounds.

You can see an airlock, a black ninja outfit, a bar (on which are a Glowing Sphere and a glittery box (closed)), a bench, a comfy looking chair, a bartender, AFrame, and a securityBot here.

* * *

>asd
asd!? Har har har! Musta been one-a them vat babies huh?

Space Lounge
You are in the Space Lounge. It's dim and glowy all over with pulsating colors and subtle hypnotic sounds.

You can see an airlock, a black ninja outfit, a bar (on which are a Glowing Sphere and a glittery box (closed)), a bench, a comfy looking chair, a bartender, AFrame, and a securityBot here.

You can go east through the airlock (closed) and west from here.

>sit chair
I didn't understand that sentence.

>sit on chair
Oh boy this chair looks really soft and comfy! Ooooh ya you are totally gonna sit on this chair big time.

You get onto the comfy looking chair.

on a soft thing 2

>sit on chair
Oh boy this chair looks really soft and comfy! Ooooh ya you are totally gonna sit on this chair big time.

"Hey Wait!" your subconscious jumps forth remembering the tempting softness - you decide not not to sit on that comfy looking chair, it's so comfy you might never get up again! It looks seriously comfy though...maybe just for a little tiny sliver of a moment you could get kinda comfy...

on a soft thing 3

>get up from chair
You just can't get up, you are way too comfortable! Maybe if you just stayed here in this comfy looking chair forever you would be better off than whatever else you were going to do. Does it really matter?

on a soft thing 2

>get up from chair
You try to heave yourself up, but the soft lusciousness of the comfy looking chair envelopes you and pulls you back into its comfy folds. Oooooo...so comfy...so sooooooofffffft...

on a soft thing 3

* * *

>asd
asd!? Har har har! Musta been one-a them vat babies huh?

Space Lounge
You are in the Space Lounge. It's dim and glowy all over with pulsating colors and subtle hypnotic sounds.

You can see an airlock, a black ninja outfit, a bar (on which are a Glowing Sphere and a glittery box (closed)), a bench, a comfy looking chair, a bartender, AFrame, and a securityBot here.

You can go east through the airlock (closed) and west from here.

>sit on chair
"What was I trying to do?" you think for a sec before you realize how comfy the chair you are in is. It's kind of incredible, you feel like you've accomlished enough in life.

>sit on chair
"What was I trying to do?" you think for a sec before you realize how comfy the chair you are in is. It's kind of incredible, you feel like you've accomlished enough in life.

>get up from chair
You just can't get up, you are way too comfortable! Maybe if you just stayed here in this comfy looking chair forever you would be better off than whatever else you were going to do. Does it really matter?

Oooh yes, this is a wonderful world. What a luxuriously decadent and beautiful reality to be in" you think as you nestle further within the folds of the chair

>get up from chair
You try to heave yourself up, but the soft lusciousness of the comfy looking chair envelopes you and pulls you back into its comfy folds. Oooooo...so comfy...so sooooooofffffft...

Oooh yes, this is a wonderful world. What a luxuriously decadent and beautiful reality to be in" you think as you nestle further within the folds of the chair

>get up from chair
Whew! You just barely escaped that comfy looking chair, it's so comfy you could get stuck in it forever!

>sit on chair
Don't you remember the last time you were in that comfy looking chair? It almost ATE YOU! What is your deal? Don't sit in this comfy looking chair, it's too dangerous! Only a master of mental projection could sit on this comfy looking chair without its super soft comfy-ness obliterating and subsuming your soul to its dark comfy desires.

>sit on chair
    *** You sit on the chair again and sink forever into its comfyness. You never rise again. ***

In that game you scored 0 out of a possible 0, in 7 turns.

Would you like to RESTART, RESTORE a saved game, QUIT, or UNDO the last command?

>restart
In the early 2000s, mewonkind's folly led to the breakdown of society and the restructuring of general cultural and technological vector-goals. At some point interest-tribes formed into coherent anarcho-syndicates, creating new economic models which began to isolate themselves in order to maximize survival attributes and minimize unknown variable influences. It was around that time the blast doors went down. Nobody's sure how long exactly; it's been hundreds of season renewals and a ton of spin-offs and crossovers since then though. At least that's what you were taught in data-download segment 2-histori-political info part 27A while syncing the standard edu-packets. Who the hell knows for real though, right?

Whatevs. Feels like just another day in the MASSIVE HIVE KNOWN as CONvergence.

BTW, you sure have made quite the number of enemies.

Today's magic number is 831.

What is your name?

>s
h, s eh!? I've heard a you.

Space Lounge
You are in the Space Lounge. It's dim and glowy all over with pulsating colors and subtle hypnotic sounds.

You can see an airlock, a black ninja outfit, a bar (on which are a Glowing Sphere and a glittery box (closed)), a bench, a comfy looking chair, a bartender, AFrame, and a securityBot here.

>sit on chair
"What was I trying to do?" you think for a sec before you realize how comfy the chair you are in is. It's kind of incredible, you feel like you've accomlished enough in life.

* * *

>asdf
asdf!? Aaaah, that's a good one.

Space Lounge
You are in the Space Lounge. It's dim and glowy all over with pulsating colors and subtle hypnotic sounds.

You can see an airlock, a black ninja outfit, a bar (on which are a Glowing Sphere and a glittery box (closed)), a bench, a comfy looking chair, a bartender, AFrame, and a securityBot here.

You can go east through the airlock (closed) and west from here.

I beg your pardon?

>look box
Time slows down, you feel as if you are gazing into the cosmos itself. Your eyeballs can hardly stay on it, it's like your gaze just keeps sliding off.

* * *

>open box
You open the glittery box, revealing a securityReadout, a bowl, and a crazy looking gun.

>look bowl
The bowl is kind of an average looking bowl.

In the bowl is a note.

>look gun
That gun is so crazy looking! It's kind of like totally blowing your mind.

* * *

>look securityReadout
The screen is blank.

The securityReadout is currently switched off.

>turn on securityReadout
You switch the securityReadout on.

>look securityReadout
The screen reads: 

 airlock (Space Lounge/Veranda Walkway): UNLOCKED

* * *

I beg your pardon?

>talk to securityBot
You say hello to the securityBot.

>i
You're carrying a message receiver, a coin, and a dagger. You're wearing DiscoWig.

>stab securityBot
I didn't understand that sentence.

>stab securityBot with dagger
I didn't understand that sentence.

>attack securityBot
Whoa this is not the time or place to be attacking people. Chill dudetron.

>look DiscoWig
This wig is all sproingy and is made of tons of tiny pieces of holographic metallic rainbow shards. As you move about the light around you is refracted into a million directions, making face recog almost impossible.

>help
Space Lounge
You are in the Space Lounge. It's dim and glowy all over with pulsating colors and subtle hypnotic sounds.

You can see an airlock, a black ninja outfit, a bar (on which are a Glowing Sphere and a glittery box (closed)), a bench, a comfy looking chair, a bartender, AFrame, and a securityBot here.

You can go east through the airlock (closed) and west from here.

>read note
You can't see any such thing.

>i
You're carrying a message receiver, a coin, and a dagger. You're wearing DiscoWig.

>look message receiver
Dear asdf, 

You really should meet me tonight in the Space Lounge...you're gonna be pumped! -AFrame

>look at AFrame
Aframe is looking pretty sharp there wearing a pin-striped suit with his usual aplomb.

>take suit from AFrame
That seems to belong to AFrame.

>ask AFrame to take off suit
I didn't understand that sentence.

>Aframe take off suit
I didn't understand that sentence.

>AFrame, take off suit
He says "sure, anything for a laugh!"
AFrame takes off the pin-striped suit.

>look Aframe
Aframe is looking pretty sharp there wearing a pink thong with his usual aplomb.

>Aframe, take off thong
He says "sure, anything for a laugh!"
AFrame takes off the pink thong.

>look aframe
Aframe is looking pretty sharp there wearing nothing with his usual aplomb.

>i
You're carrying a message receiver, a coin, and a dagger. You're wearing DiscoWig.

>look
Space Lounge
You are in the Space Lounge. It's dim and glowy all over with pulsating colors and subtle hypnotic sounds.

You can see an airlock, a black ninja outfit, a bar (on which are a Glowing Sphere and a glittery box (closed)), a bench, a comfy looking chair, a bartender, AFrame, and a securityBot here.

You can go east through the airlock (closed) and west from here.

>look aframe
Aframe is looking pretty sharp there wearing nothing with his usual aplomb.

>take suit
That seems to belong to AFrame.

>Aframe, give suit
Whom do you want AFrame to give the pin-striped suit to?

>AFrame, give suit to me
He says "sure, anything for a laugh!"
AFrame is unable to do that.

>put on ninja suit
You can't see any such thing.

>take n
You must name something more substantial.

>take nin
You can't see any such thing.

>take ninja
(the black ninja outfit)
Taken.

>put on ninja suit
You can't see any such thing.

>wear ninja suit
You can't see any such thing.

>i
You're carrying a black ninja outfit, a message receiver, a coin, and a dagger. You're wearing DiscoWig.

>wear ninja
(the black ninja outfit)
You are a ninja! It feels like you could blend into the shadows, or maybe you ARE the shadows, this ninja outfit makes you feel super ninja-like

>look
Space Lounge
You are in the Space Lounge. It's dim and glowy all over with pulsating colors and subtle hypnotic sounds.

You can see an airlock, a bar (on which are a Glowing Sphere and a glittery box (closed)), a bench, a comfy looking chair, a bartender, AFrame, and a securityBot here.

You can go east through the airlock (closed) and west from here.

>e
(first opening the airlock)
As you enter the Veranda Walkway you see a floating dolphin surveillance pod.
Sweet, it seems like your DiscoWig shielded you from detection. 

Veranda Walkway
Outside the Space Lounge you look out into the larger Raditree Building to see the pool under a high ceiling. Consuite lies beyond the pool in the main courtyard. Boffers beat each other up in the fenced in section of the courtyard. There's a floating platform above the pool.

You can see an airlock, a black rod, and a floating dolphin (closed) here.

You can go north, northeast, northwest, southeast, west through the airlock to the Space Lounge, up, and down from here.

>down
Under the Veranda Walkway
You can go north, northeast, southeast, east, west, and up to the Veranda Walkway from here.

>e
Garden Court
Garden Court

You can see a boffer here.

You can go west to Under the Veranda Walkway from here.

>attack boffer
You attack the boffer, causing 6 points of damage! The boffer has -1 hit points
The boffer is defeated! He stands up and gives you his staff, "Nobody has defeated me in a long time. This is yours now."

* * *

>asdf
asdf!? Aaaah, that's a good one.

Space Lounge
You are in the Space Lounge. It's dim and glowy all over with pulsating colors and subtle hypnotic sounds.

You can see an airlock, a black ninja outfit, a bar (on which are a Glowing Sphere and a glittery box (closed)), a bench, a comfy looking chair, a bartender, AFrame, and a securityBot here.

You can go east through the airlock (closed) and west from here.

>attack Aframe
You attack AFrame, causing 7 points of damage!

AFrame attacks you, causing 2 points of damage!

>attack Aframe
You attack AFrame, causing 9 points of damage!

AFrame attacks you, causing 5 points of damage!

>attack Aframe
You attack AFrame, causing 4 points of damage!

AFrame attacks you, causing 2 points of damage!

>attack Aframe
You attack AFrame, causing 5 points of damage!

AFrame attacks you, causing 6 points of damage!

Your cool ninja body expires from the attack! As you lose consciousness you use your mystical ninja abilities to become an incredibly powerful ninja ghost - even death cannot stop your thirst for VENGEANCE, though that is another story.

    *** The End ***

In that game you scored 0 out of a possible 0, in 4 turns.

Would you like to RESTART, RESTORE a saved game, QUIT, or UNDO the last command?

>restart
In the early 2000s, mewonkind's folly led to the breakdown of society and the restructuring of general cultural and technological vector-goals. At some point interest-tribes formed into coherent anarcho-syndicates, creating new economic models which began to isolate themselves in order to maximize survival attributes and minimize unknown variable influences. It was around that time the blast doors went down. Nobody's sure how long exactly; it's been hundreds of season renewals and a ton of spin-offs and crossovers since then though. At least that's what you were taught in data-download segment 2-histori-political info part 27A while syncing the standard edu-packets. Who the hell knows for real though, right?

Whatevs. Feels like just another day in the MASSIVE HIVE KNOWN as CONvergence.

BTW, you sure have made quite the number of enemies.

Today's magic number is 769.

What is your name?

* * *

>asdf
asdf!? Aaaah, that's a good one.

Space Lounge
You are in the Space Lounge. It's dim and glowy all over with pulsating colors and subtle hypnotic sounds.

You can see an airlock, a black ninja outfit, a bar (on which are a Glowing Sphere and a glittery box (closed)), a bench, a comfy looking chair, a bartender, AFrame, and a securityBot here.

You can go east through the airlock (closed) and west from here.

>attack aframe
some stuff

I beg your pardon?

* * *

>attack aframe
some stuff

>asdf
I didn't understand that sentence.

>attack aframe
You attack AFrame, causing 10 points of damage! AFrame has 990 hit points
AFrame attacks you, causing 5 points of damage! You have 2 hit points
You die in battle, like a warrior!

    *** The End ***

In that game you scored 0 out of a possible 0, in 2 turns.

Would you like to RESTART, RESTORE a saved game, QUIT, or UNDO the last command?

* * *

>attack aframe
some stuff

>attack aframe
You attack AFrame, causing 8 points of damage! AFrame has 986 hit points
AFrame attacks you, causing 5 points of damage! You have -1 hit points
You die in battle, like a warrior!

    *** The End ***

In that game you scored 0 out of a possible 0, in 2 turns.

Would you like to RESTART, RESTORE a saved game, QUIT, or UNDO the last command?

>restart
In the early 2000s, mewonkind's folly led to the breakdown of society and the restructuring of general cultural and technological vector-goals. At some point interest-tribes formed into coherent anarcho-syndicates, creating new economic models which began to isolate themselves in order to maximize survival attributes and minimize unknown variable influences. It was around that time the blast doors went down. Nobody's sure how long exactly; it's been hundreds of season renewals and a ton of spin-offs and crossovers since then though. At least that's what you were taught in data-download segment 2-histori-political info part 27A while syncing the standard edu-packets. Who the hell knows for real though, right?

Whatevs. Feels like just another day in the MASSIVE HIVE KNOWN as CONvergence.

BTW, you sure have made quite the number of enemies.

Today's magic number is 470.

What is your name?

>adfs
adfs? Interesting, nice.

Space Lounge
You are in the Space Lounge. It's dim and glowy all over with pulsating colors and subtle hypnotic sounds.

You can see an airlock, a black ninja outfit, a bar (on which are a Glowing Sphere and a glittery box (closed)), a bench, a comfy looking chair, a bartender, AFrame, and a securityBot here.

You can go east through the airlock (closed) and west from here.

>attack aframe with dagger
I only understood you as far as wanting to attack AFrame.

* * *

>e
(first opening the airlock)
As you enter the Veranda Walkway you see a floating dolphin surveillance pod.
Sweet, it seems like your DiscoWig shielded you from detection. 

Veranda Walkway
Outside the Space Lounge you look out into the larger Raditree Building to see the pool under a high ceiling. Consuite lies beyond the pool in the main courtyard. Boffers beat each other up in the fenced in section of the courtyard. There's a floating platform above the pool.

You can see an airlock, a black rod, and a floating dolphin (closed) here.

You can go north, northeast, northwest, southeast, west through the airlock to the Space Lounge, up, and down from here.

>d
Under the Veranda Walkway
You can go north, northeast, southeast, east, west, and up to the Veranda Walkway from here.

* * *

>attack aframe
some stuff

>e
(first opening the airlock)
As you enter the Veranda Walkway you see a floating dolphin surveillance pod.
Sweet, it seems like your ElectroMisdirector shielded you from detection. 

Veranda Walkway
Outside the Space Lounge you look out into the larger Raditree Building to see the pool under a high ceiling. Consuite lies beyond the pool in the main courtyard. Boffers beat each other up in the fenced in section of the courtyard. There's a floating platform above the pool.

You can see an airlock, a black rod, and a floating dolphin (closed) here.

You can go north, northeast, northwest, southeast, west through the airlock to the Space Lounge, up, and down from here.

>d
Under the Veranda Walkway
You can go north, northeast, southeast, east, west, and up to the Veranda Walkway from here.

* * *

>e
Garden Court
Garden Court

You can see a boffer here.

You can go west to Under the Veranda Walkway from here.

>attack boffer
You attack the boffer, causing 7 points of damage! The boffer has -2 hit points
The boffer is defeated! He stands up and gives you his staff, "Nobody has defeated me in a long time. This is yours now."

* * *

>asdf
asdf!? Aaaah, that's a good one.

Space Lounge
You are in the Space Lounge. It's dim and glowy all over with pulsating colors and subtle hypnotic sounds.

You can see an airlock, a black ninja outfit, a bar (on which are a Glowing Sphere and a glittery box (closed)), a bench, a comfy looking chair, a bartender, AFrame, and a securityBot here.

You can go east through the airlock (closed) and west from here.

>e
(first opening the airlock)
As you enter the Veranda Walkway you see a floating dolphin surveillance pod.
Sweet, it seems like your AdBlaster2000 shielded you from detection. 

Veranda Walkway
Outside the Space Lounge you look out into the larger Raditree Building to see the pool under a high ceiling. Consuite lies beyond the pool in the main courtyard. Boffers beat each other up in the fenced in section of the courtyard. There's a floating platform above the pool.

You can see an airlock, a black rod, and a floating dolphin (closed) here.

You can go north, northeast, northwest, southeast, west through the airlock to the Space Lounge, up, and down from here.

>d
Under the Veranda Walkway
You can go north, northeast, southeast, east, west, and up to the Veranda Walkway from here.

* * *

>attack boffer
You attack the boffer, causing 7 points of damage! The boffer has -2 hit points
The boffer is defeated! He stands up and gives you his staff, "Nobody has defeated me in a long time. This is yours now."

>w
Under the Veranda Walkway
You can go north, northeast, southeast, east to the Garden Court, west, and up to the Veranda Walkway from here.

>u
As you enter the Veranda Walkway you see a floating dolphin surveillance pod.
Sweet, it seems like your AdBlaster2000 shielded you from detection. 

Veranda Walkway
Outside the Space Lounge you look out into the larger Raditree Building to see the pool under a high ceiling. Consuite lies beyond the pool in the main courtyard. Boffers beat each other up in the fenced in section of the courtyard. There's a floating platform above the pool.

You can see an airlock, a black rod, and a floating dolphin (closed) here.

You can go north, northeast, northwest, southeast, west through the airlock to the Space Lounge, up, and down to Under the Veranda Walkway from here.

>w
Space Lounge
You are in the Space Lounge. It's dim and glowy all over with pulsating colors and subtle hypnotic sounds.

You can see an airlock, a black ninja outfit, a bar (on which are a Glowing Sphere and a glittery box (closed)), a bench, a comfy looking chair, a bartender, AFrame, and a securityBot here.

You can go east through the airlock to the Veranda Walkway and west from here.

>attack bartender
Whoa this is not the time or place to be attacking people, chill dude.

* * *

>i
You're carrying a message receiver, a coin, and a dagger. You're wearing AdBlaster2000.

* * *

>se
Upper Southside Hallway
This hallway is NUTS - there are signs everywhere and lights and sounds flashing. From this hallway you can get into a bunch of Party Rooms

You can go north, northeast, northwest to the Veranda Walkway, south, southeast, and southwest from here.

>s
Staging Area
You can see a yellow jersey, a polkadot jersey, a green jersey, a white jersey, a blue jersey, DiscoWig, and AdBlaster2000 here.

You can go north to the Upper Southside Hallway from here.

>look AdBlaster2000
A little robot that follows you around projecting fragmented images of the Yummy Little Fingers Yum Yum Brand (hereby licensed). Effectively shrouds your own identity by covering it with constantly moving Little Fingers ads. It is kind of annoying for anyone you try to talk to though. (Tends to make people hungry).

>look
Staging Area
You can see a yellow jersey, a polkadot jersey, a green jersey, a white jersey, a blue jersey, DiscoWig, and AdBlaster2000 here.

You can go north to the Upper Southside Hallway from here.

>n
Upper Southside Hallway
This hallway is NUTS - there are signs everywhere and lights and sounds flashing. From this hallway you can get into a bunch of Party Rooms

You can go north, northeast, northwest to the Veranda Walkway, south to the Staging Area, southeast, and southwest from here.

>se
Round1
Welcome to Trivia, I'm your host, a computer program super full of useless information. You will be rewarded with an object based on your score at the end of the quiz.

Wrong answers will not be rewarded with correct answers - I'm not telling you the right answer.

I have ONE singular accepted ABSOLUTELY CORRECT answer it's in a table and it is EXACT and PERFECT - I am the ULTIMATE IMPARTIAL QUIZ JUDGE. If you don't like it...cry me a spriver! OH also you are trapped within my quizzy embrace until the end so just accept your fate. Srsly don't try to leave or anything you'll just waste your answer-chances. The quiz is only four rounds of four questions each - just relax you're not stuck in a Quiz Vortex or anything...(I hope...)

Questions in the first round are worth 5 points a piece, but will increase in value as the game goes on.

Answers must be given with Capitalization and exact spelling.

-----------

The first section is on films involving simulated realities and questionable memories.

Who are you? Are you your memories? Are you what you have done? Are you what you will do? Or are you nothing at all but a wisp...or maybe "just" a program? 

You can go northwest to the Upper Southside Hallway from here.

In which movie did the main character die from super disturbing eye bulging decompression after helmet face plate breakage in the opening scene then but it turned out was just a dream? (or was it a premonition? or was it an implanted memory?)

Please enter your answer

* * *

>se
Upper Southside Hallway
This hallway is NUTS - there are signs everywhere and lights and sounds flashing. From this hallway you can get into a bunch of Party Rooms

You can go north, northeast, northwest to the Veranda Walkway, south, southeast, and southwest from here.

>se
Round1
Welcome to Trivia, I'm your host, a computer program super full of useless information. You will be rewarded with an object based on your score at the end of the quiz.

Wrong answers will not be rewarded with correct answers - I'm not telling you the right answer.

I have ONE singular accepted ABSOLUTELY CORRECT answer it's in a table and it is EXACT and PERFECT - I am the ULTIMATE IMPARTIAL QUIZ JUDGE. If you don't like it...cry me a spriver! OH also you are trapped within my quizzy embrace until the end so just accept your fate. Srsly don't try to leave or anything you'll just waste your answer-chances. The quiz is only four rounds of four questions each - just relax you're not stuck in a Quiz Vortex or anything...(I hope...)

Questions in the first round are worth 5 points a piece, but will increase in value as the game goes on.

Answers must be given with Capitalization and exact spelling.

-----------

The first section is on films involving simulated realities and questionable memories.

Who are you? Are you your memories? Are you what you have done? Are you what you will do? Or are you nothing at all but a wisp...or maybe "just" a program? 

In which film did someone get offered a choice between two pills and then didn't take both of them like they should have?

Please enter your answer

I beg your pardon?

Please enter your answer

>asdf
Incorrect. Next question.

In which movie did the main character die from super disturbing eye bulging decompression after helmet face plate breakage in the opening scene then but it turned it was just a dream? (or was it a premonition? or was it an implanted memory?)

Please enter your answer

>afd
Incorrect. Next question.

In which film did someone get offered a choice between two pills and then didn't take both of them like they should have?

Please enter your answer

>safd
Incorrect. Next question.

This film has annoying gothy villians but a super cool reveal that everyone was in a giant space habitat the WHOLE TIME?! (btw foreshadowing...)

Please enter your answer

>asdf
That was Round One, now onto Round Two!

Round2
Now onto Round Two where the questions are worth ten points a piece. The subject of this round is Interactive Fiction! M(meta)E(meta)T(meta)A

You can see no obvious exits.

(There are no routes out of this room.)

Colossal Cave Adventure featured a "magic word" that caused teleportation and has shown up again and again in video games ever since.  It enables cheat modes, opens Easter Eggs and has inspired many silly programs. Type this magic word in lowercase now.

Please enter your answer

>xyzzy
Well done.  Next question.

In what game series are you likely to be eaten by a grue if you travel into dark places without a light source?

Please enter your answer

>Zork
Well done.  Next question.

This Apple II game features a game play element where the player is given a three-digit code at the beginning of play and is instructed to never reveal this code to anyone. At one point the game appears to crash as a way of tricking the player into revealing their code, in which case they lose the game. What is the name of this game?

Please enter your answer

>The Psdf
That was Round Two, now onto Round Three!

Round3
Round Three is here! The questions are harder but now worth fifteen points a piece. These ones are about going INSIDE THE COMPUTER!

You can see no obvious exits.

(There are no routes out of this room.)

What is the name of the anime about a VRMMORPG where the players have to play until they either die or someone beats the game? No logging out. WHAAaaaa? Wicked eh?

Please enter your answer

>Sword Art Online
Well done.  Next question.

Who is the actor who played the program Crom in Tron - you might also know him as Londo...

Please enter your answer

>asfd
That was Round Three, now onto Round Four!

Round4
This is it, the final round. You're so close to escaping this quiz that not even a Quiz Vortex could keep you from exiting the quiz-field. The questions are worth twenty points a piece.

This round is about choices, random forces and what they lead to...which is of course PARALLEL UNIVERSES!

Every imagined-not-taken choice spawned from every individual's mind throughout time and space creating entire universes with every passing thought. The vast sea of thought embracing the infinite seeds of thought; the birth of what-ifs reflecting infinitely. 

You can see no obvious exits.

(There are no routes out of this room.)

What is the name of the author who wrote about Sir Luther of Arkwright - a hero who can travel through the parallels at will?

Please enter your answer

>Brian Talbot
Well done.  Next question.

Who wrote a series of stories about children travelling between parallel worlds with a powerful knife, and has book titles inspired by Paradise Lost?

Please enter your answer

>asdf
Incorrect. Next question.

Who wrote The Coming of the Quantam Cats, which includes a parallel universe prison planet, and a triad -relationship including three different versions of the same person? (OMG that is so hawt!)

Please enter your answer

>df
Incorrect. Next question.

What movie about parallel universes involves a good version of Jet Li trying to stop an evil version of Jet Li who is determined to gain ultimate power by being the only version of himself throughout all universes?

Please enter your answer

>dfs
Incorrect. That was the end of Round Four.

End
Final Score: 55/200

You can go northeast to the Upper Southside Hallway from here.

(From here, you can move to northeast.)

>ne
Upper Southside Hallway
This hallway is NUTS - there are signs everywhere and lights and sounds flashing. From this hallway you can get into a bunch of Party Rooms

You can go north, northeast, northwest to the Veranda Walkway, south, southeast to the Round1, and southwest to the End from here.

(From here, you can move to north, northeast, northwest, south, southeast, and southwest.)

[Your score has just gone up by fifty-five points.]

* * *

I beg your pardon?

Please enter your answer

>sdf
Incorrect. Next question.

This film has annoying gothy villians but a super cool reveal that everyone was in a giant space habitat the WHOLE TIME?! (btw foreshadowing...)

Please enter your answer

>sfd
Incorrect. Next question.

This movie has a sail boat smash into the end of a fake world. Everyone watching just goes totally nuts.

Please enter your answer

>sfd
Incorrect. Next question.

In which movie did the main character die from super disturbing eye bulging decompression after helmet face plate breakage in the opening scene then but it turned out was just a dream? (or was it a premonition? or was it an implanted memory?)

Please enter your answer

>sdf
That was Round One, now onto Round Two!

Round2
Now onto Round Two where the questions are worth ten points a piece. The subject of this round is Interactive Fiction! M(meta)E(meta)T(meta)A

Colossal Cave Adventure featured a "magic word" that caused teleportation and has shown up again and again in video games ever since.  It enables cheat modes, opens Easter Eggs and has inspired many silly programs. Type this magic word in lowercase now.

Please enter your answer

>sfd
Incorrect. Next question.

This Apple II game features a game play element where the player is given a three-digit code at the beginning of play and is instructed to never reveal this code to anyone. At one point the game appears to crash as a way of tricking the player into revealing their code, in which case they lose the game. What is the name of this game?

Please enter your answer

>sdf
Incorrect. Next question.

In what game series are you likely to be eaten by a grue if you travel into dark places without a light source?

Please enter your answer

>sdf
Incorrect. Next question.

Around 1975, a programmer and amateur caver wrote the first text adventure game whose name originally was all caps and only six characters long because of filename length limitations of that time. What is the name of this game (the all-caps six letter version)

Please enter your answer

>sdf
That was Round Two, now onto Round Three!

Round3
Round Three is here! The questions are harder but now worth fifteen points a piece. These ones are about going INSIDE THE COMPUTER!

What is the name of the anime about a VRMMORPG where the players have to play until they either die or someone beats the game? No logging out. WHAAaaaa? Wicked eh?

Please enter your answer

>sdf
Incorrect. Next question.

This character started out as a real-life-human-reporter but after someone tried to kill him he ended up in a coma and then got his mind uploaded TO A COMPUTER. The transition altered his personality forever.

Please enter your answer

>sdf
Incorrect. Next question.

This 1980"s movie about Virtual Reality was such garbage that it basically halted research and tech development in VR for about 20 years.

Please enter your answer

>sdf
Incorrect. Next question.

Who is the actor who played the program Crom in Tron - you might also know him as Londo...

Please enter your answer

>sdf
That was Round Three, now onto Round Four!

Round4
This is it, the final round. You're so close to escaping this quiz that not even a Quiz Vortex could keep you from exiting the quiz-field. The questions are worth twenty points a piece.

This round is about choices, random forces and what they lead to...which is of course PARALLEL UNIVERSES!

Every imagined-not-taken choice spawned from every individual's mind throughout time and space creating entire universes with every passing thought. The vast sea of thought embracing the infinite seeds of thought; the birth of what-ifs reflecting infinitely. 

Who wrote The Coming of the Quantum Cats, which includes a parallel universe prison planet, and a triad -relationship including three different versions of the same person? (OMG that is so hawt!)

Please enter your answer

>sdf
Incorrect. Next question.

What movie about parallel universes involves a good version of Jet Li trying to stop an evil version of Jet Li who is determined to gain ultimate power by being the only version of himself throughout all universes?

Please enter your answer

>sdf
Incorrect. Next question.

Who wrote a series of stories about children travelling between parallel worlds with a powerful knife, and has book titles inspired by Paradise Lost?

Please enter your answer

>sdf
Incorrect. Next question.

What is the name of the author who wrote about Sir Luther of Arkwright - a hero who can travel through the parallels at will?

Please enter your answer

>sdf
Incorrect. That was the end of Round Four.

End
Final Score: 0/200

You can go northeast to the Upper Southside Hallway from here.

I beg your pardon?

>ne
Upper Southside Hallway
This hallway is NUTS - there are signs everywhere and lights and sounds flashing. From this hallway you can get into a bunch of Party Rooms

You can go north, northeast, northwest to the Veranda Walkway, south, southeast to the Round1, and southwest to the End from here.

* * *

>Total Recall
Well done.  Next question.

This movie has a sail boat smash into the end of a fake world. Everyone watching just goes totally nuts.

Please enter your answer

>The Truman Show
Well done.  Next question.

This film has annoying gothy villians but a super cool reveal that everyone was in a giant space habitat the WHOLE TIME?! (btw foreshadowing...)

Please enter your answer

* * *

>Dark City
Well done.  Next question.

In which film did someone get offered a choice between two pills and then didn't take both of them like they should have?

Please enter your answer

>The Matrix
That was Round One, now onto Round Two!

Round2
Now onto Round Two where the questions get slightly harder but are worth ten points a piece.

You can see no obvious exits.

(There are no routes out of this room.)

Get a Mac was an ad slogan for what company from 2006 to 2009? 

Please enter your answer

>Apple
Well done.  Next question.

What is the capital of Egypt?

Please enter your answer

>Cairo
Well done.  Next question.

In the contract version of what card game are players identified by points on the compass?

Please enter your answer

>Bridge
Well done.  Next question.

What movie has the Highland Games, a Witch, and Craig Ferguson as Lord Macintosh?

Please enter your answer

>Brave
That was Round Two, now onto Round Three where things get a bit more difficult!

Round3
Round Three is here! The questions are harder but now worth fifteen points a piece.

You can see no obvious exits.

(There are no routes out of this room.)

Ebony and Ivory was a duet performed by Stevie Wonder and what former Beatle?

Please enter your answer

>Paul McCartney
Well done.  Next question.

In what year did Spongebob Squarepants premier on television, Wide Open Spaces by the Dixie Chicks won a Grammy, and the Sixth Sense premiered in theaters?

Please enter your answer

>1999
Well done.  Next question.

The Original Ritz Hotel is located in what European City?

Please enter your answer

>Paris
Well done.  Next question.

In 1908, what Ford Model was first produced, eventually being named the Car of the Century?

Please enter your answer

>Model T
That was Round Three, now onto Round Four!

Round4
This is it, the final round. Europe's The Final Countdown is now playing on loop in your head and the questions are worth a whopping twenty points a piece.

You can see no obvious exits.

(There are no routes out of this room.)

Who wrote a series of stories about children travelling between parallel worlds with a powerful knife?

Please enter your answer

>Philip Pullman
Well done.  Next question.

Who wrote The Coming of the Quantam Cats?

Please enter your answer

>Frederick Pohl
Well done.  Next question.

What is the name of the author who wrote about Sir Luther of Arkwright?

Please enter your answer

* * *

>asdf
Incorrect. Next question.

In which film did someone get offered a choice between two pills and then didn't take both of them like they should have?

Please enter your answer

>asdf
Incorrect. Next question.

In which movie did the main character die from super disturbing eye bulging decompression after helmet face plate breakage in the opening scene then but it turned it was just a dream? (or was it a premonition? or was it an implanted memory?)

Please enter your answer

>afsd
Incorrect. Next question.

This movie has a sail boat smash into the end of a fake world. Everyone watching just goes totally nuts.

Please enter your answer

>fasd
That was Round One, now onto Round Two!

Round2
Now onto Round Two where the questions are worth ten points a piece. The subject of this round is Interactive Fiction! M(meta)E(meta)T(meta)A

In what game series are you likely to be eaten by a grue if you travel into dark places without a light source?

Please enter your answer

>sfd
That was Round Two, now onto Round Three!

Round3
Round Three is here! The questions are harder but now worth fifteen points a piece. These ones are about going INSIDE THE COMPUTER!

This 80"s movie about Virtual Reality was such garbage that it basically halted research and tech development in VR for about 20 years.

Please enter your answer

>fdsa
That was Round Three, now onto Round Four!

Round4
This is it, the final round. You're so close to escaping this quiz that not even a Quiz Vortex could keep you from exiting the quiz-field. The questions are worth twenty points a piece.

This round is about choices, random forces and what they lead to...which is of course PARALLEL UNIVERSES!

Every imagined-not-taken choice spawned from every individual's mind throughout time and space creating entire universes with every passing thought. The vast sea of thought embracing the infinite seeds of thought; the birth of what-ifs reflecting infinitely. 

What is the name of the author who wrote about Sir Luther of Arkwright - a hero who can travel through the parallels at will?

Please enter your answer

>fds
Incorrect. Next question.

What movie about parallel universes involves a good version of Jet Li trying to stop an evil version of Jet Li who is determined to gain ultimate power by being the only version of himself throughout all universes?

Please enter your answer

>adfs
Incorrect. Next question.

Who wrote a series of stories about children travelling between parallel worlds with a powerful knife, and has book titles inspired by Paradise Lost?

Please enter your answer

>dfs
Incorrect. Next question.

Who wrote The Coming of the Quantam Cats, which includes a parallel universe prison planet, and a triad -relationship including three different versions of the same person? (OMG that is so hawt!)

Please enter your answer

>sadf
Incorrect. That was the end of Round Four.

End
Final Score: 0/200

* * *

>asdf
Incorrect. Next question.

In which movie did the main character die from super disturbing eye bulging decompression after helmet face plate breakage in the opening scene then but it turned it was just a dream? (or was it a premonition? or was it an implanted memory?)

Please enter your answer

>asdf
Incorrect. Next question.

This movie has a sail boat smash into the end of a fake world. Everyone watching just goes totally nuts.

Please enter your answer

>asdf
That was Round One, now onto Round Two!

Round2
Now onto Round Two where the questions are worth ten points a piece. The subject of this round is Interactive Fiction! M(meta)E(meta)T(meta)A

In what game series are you likely to be eaten by a grue if you travel into dark places without a light source?

Please enter your answer

>sdf
Incorrect. Next question.

This Apple II game features a game play element where the player is given a three-digit code at the beginning of play and is instructed to never reveal this code to anyone. At one point the game appears to crash as a way of tricking the player into revealing their code, in which case they lose the game. What is the name of this game?

Please enter your answer

>sdf
Incorrect. Next question.

Around 1975, a programmer and amateur caver wrote the first text adventure game whose name originally was all caps and only six characters long because of filename length limitations of that time. What is the name of this game (the all-caps six letter version)

Please enter your answer

>sdf
Incorrect. Next question.

Colossal Cave Adventure featured a "magic word" that caused teleportation and has shown up again and again in video games ever since.  It enables cheat modes, opens Easter Eggs and has inspired many silly programs. Type this magic word in lowercase now.

Please enter your answer

>sdf
That was Round Two, now onto Round Three!

Round3
Round Three is here! The questions are harder but now worth fifteen points a piece. These ones are about going INSIDE THE COMPUTER!

What is the name of the anime about a VRMMORPG where the players have to play until they either die or someone beats the game? No logging out. WHAAaaaa? Wicked eh?

Please enter your answer

>sfd
Incorrect. Next question.

This 80"s movie about Virtual Reality was such garbage that it basically halted research and tech development in VR for about 20 years.

Please enter your answer

>sdf
Incorrect. Next question.

Who is the actor who played the program Crom in Tron - you might also know him as Londo...

Please enter your answer

>sdf
Incorrect. Next question.

This character started out as a real-life-human-reporter but after someone tried to kill him he ended up in a coma and then got his mind uploaded TO A COMPUTER. The transition altered his personality forever.

Please enter your answer

>sdf
That was Round Three, now onto Round Four!

Round4
This is it, the final round. You're so close to escaping this quiz that not even a Quiz Vortex could keep you from exiting the quiz-field. The questions are worth twenty points a piece.

This round is about choices, random forces and what they lead to...which is of course PARALLEL UNIVERSES!

Every imagined-not-taken choice spawned from every individual's mind throughout time and space creating entire universes with every passing thought. The vast sea of thought embracing the infinite seeds of thought; the birth of what-ifs reflecting infinitely. 

Who wrote The Coming of the Quantam Cats, which includes a parallel universe prison planet, and a triad -relationship including three different versions of the same person? (OMG that is so hawt!)

Please enter your answer

>sfd
Incorrect. Next question.

Who wrote a series of stories about children travelling between parallel worlds with a powerful knife, and has book titles inspired by Paradise Lost?

Please enter your answer

>sdf
Incorrect. Next question.

What is the name of the author who wrote about Sir Luther of Arkwright - a hero who can travel through the parallels at will?

Please enter your answer

>sdf
Incorrect. Next question.

What movie about parallel universes involves a good version of Jet Li trying to stop an evil version of Jet Li who is determined to gain ultimate power by being the only version of himself throughout all universes?

Please enter your answer

>sdf
Incorrect. That was the end of Round Four.

End
Final Score: 0/200

* * *

>dfs
Incorrect. Next question.

This film has annoying gothy villians but a super cool reveal that everyone was in a giant space habitat the WHOLE TIME?! (btw foreshadowing...)

Please enter your answer

>sdf
Incorrect. Next question.

In which movie did the main character die from super disturbing eye bulging decompression after helmet face plate breakage in the opening scene then but it turned out was just a dream? (or was it a premonition? or was it an implanted memory?)

Please enter your answer

>fsd
Incorrect. Next question.

This movie has a sail boat smash into the end of a fake world. Everyone watching just goes totally nuts.

Please enter your answer

>sdf
That was Round One, now onto Round Two!

Round2
Now onto Round Two where the questions are worth ten points a piece. The subject of this round is Interactive Fiction! M(meta)E(meta)T(meta)A

Around 1975, a programmer and amateur caver wrote the first text adventure game whose name originally was all caps and only six characters long because of filename length limitations of that time. What is the name of this game (the all-caps six letter version)

Please enter your answer

>sfd
Incorrect. Next question.

In what game series are you likely to be eaten by a grue if you travel into dark places without a light source?

Please enter your answer

>fsd
Incorrect. Next question.

This Apple II game features a game play element where the player is given a three-digit code at the beginning of play and is instructed to never reveal this code to anyone. At one point the game appears to crash as a way of tricking the player into revealing their code, in which case they lose the game. What is the name of this game?

Please enter your answer

>fd
Incorrect. Next question.

Colossal Cave Adventure featured a "magic word" that caused teleportation and has shown up again and again in video games ever since.  It enables cheat modes, opens Easter Eggs and has inspired many silly programs. Type this magic word in lowercase now.

Please enter your answer

>fsd
That was Round Two, now onto Round Three!

Round3
Round Three is here! The questions are harder but now worth fifteen points a piece. These ones are about going INSIDE THE COMPUTER!

What is the name of the anime about a VRMMORPG where the players have to play until they either die or someone beats the game? No logging out. WHAAaaaa? Wicked eh?

Please enter your answer

>fsd
Incorrect. Next question.

Who is the actor who played the program Crom in Tron - you might also know him as Londo...

Please enter your answer

>sdf
Incorrect. Next question.

This 1980"s movie about Virtual Reality was such garbage that it basically halted research and tech development in VR for about 20 years.

Please enter your answer

>sdf
Incorrect. Next question.

This character started out as a real-life-human-reporter but after someone tried to kill him he ended up in a coma and then got his mind uploaded TO A COMPUTER. The transition altered his personality forever.

Please enter your answer

>sfd
That was Round Three, now onto Round Four!

Round4
This is it, the final round. You're so close to escaping this quiz that not even a Quiz Vortex could keep you from exiting the quiz-field. The questions are worth twenty points a piece.

This round is about choices, random forces and what they lead to...which is of course PARALLEL UNIVERSES!

Every imagined-not-taken choice spawned from every individual's mind throughout time and space creating entire universes with every passing thought. The vast sea of thought embracing the infinite seeds of thought; the birth of what-ifs reflecting infinitely. 

What movie about parallel universes involves a good version of Jet Li trying to stop an evil version of Jet Li who is determined to gain ultimate power by being the only version of himself throughout all universes?

Please enter your answer

>fds
Incorrect. Next question.

What is the name of the author who wrote about Sir Luther of Arkwright - a hero who can travel through the parallels at will?

Please enter your answer

>sdf
Incorrect. Next question.

Who wrote a series of stories about children travelling between parallel worlds with a powerful knife, and has book titles inspired by Paradise Lost?

Please enter your answer

>sfd
Incorrect. Next question.

Who wrote The Coming of the Quantum Cats, which includes a parallel universe prison planet, and a triad -relationship including three different versions of the same person? (OMG that is so hawt!)

Please enter your answer

>fsd
Incorrect. That was the end of Round Four.

End
Final Score: 0/200

You can go northeast to the Upper Southside Hallway from here.

>ne
Upper Southside Hallway
This hallway is NUTS - there are signs everywhere and lights and sounds flashing. From this hallway you can get into a bunch of Party Rooms

You can go north, northeast, northwest to the Veranda Walkway, south, southeast to the Round1, and southwest to the End from here.

* * *

>k
Incorrect. Next question.

In which movie did the main character die from super disturbing eye bulging decompression after helmet face plate breakage in the opening scene then but it turned out was just a dream? (or was it a premonition? or was it an implanted memory?)

Please enter your answer

I beg your pardon?

Please enter your answer

>kkkk
Incorrect. Next question.

This film has annoying gothy villians but a super cool reveal that everyone was in a giant space habitat the WHOLE TIME?! (btw foreshadowing...)

Please enter your answer

>kkk
Incorrect. Next question.

This movie has a sail boat smash into the end of a fake world. Everyone watching just goes totally nuts.

Please enter your answer

>kkk
That was Round One, now onto Round Two!

Round2
Now onto Round Two where the questions are worth ten points a piece. The subject of this round is Interactive Fiction! M(meta)E(meta)T(meta)A

In what game series are you likely to be eaten by a grue if you travel into dark places without a light source?

Please enter your answer

>ll
Incorrect. Next question.

This Apple II game features a game play element where the player is given a three-digit code at the beginning of play and is instructed to never reveal this code to anyone. At one point the game appears to crash as a way of tricking the player into revealing their code, in which case they lose the game. What is the name of this game?

Please enter your answer

I beg your pardon?

Please enter your answer

>l
Incorrect. Next question.

Colossal Cave Adventure featured a "magic word" that caused teleportation and has shown up again and again in video games ever since.  It enables cheat modes, opens Easter Eggs and has inspired many silly programs. Type this magic word in lowercase now.

Please enter your answer

I beg your pardon?

Please enter your answer

>ll
Incorrect. Next question.

Around 1975, a programmer and amateur caver wrote the first text adventure game whose name originally was all caps and only six characters long because of filename length limitations of that time. What is the name of this game (the all-caps six letter version)

Please enter your answer

I beg your pardon?

Please enter your answer

>l
That was Round Two, now onto Round Three!

Round3
Round Three is here! The questions are harder but now worth fifteen points a piece. These ones are about going INSIDE THE COMPUTER!

This 1980"s movie about Virtual Reality was such garbage that it basically halted research and tech development in VR for about 20 years.

Please enter your answer

I beg your pardon?

Please enter your answer

I beg your pardon?

Please enter your answer

>l
Incorrect. Next question.

This character started out as a real-life-human-reporter but after someone tried to kill him he ended up in a coma and then got his mind uploaded TO A COMPUTER. The transition altered his personality forever.

Please enter your answer

I beg your pardon?

Please enter your answer

>l
Incorrect. Next question.

Who is the actor who played the program Crom in Tron - you might also know him as Londo...

Please enter your answer

I beg your pardon?

Please enter your answer

>l
Incorrect. Next question.

What is the name of the anime about a VRMMORPG where the players have to play until they either die or someone beats the game? No logging out. WHAAaaaa? Wicked eh?

Please enter your answer

I beg your pardon?

Please enter your answer

>ll
That was Round Three, now onto Round Four!

Round4
This is it, the final round. You're so close to escaping this quiz that not even a Quiz Vortex could keep you from exiting the quiz-field. The questions are worth twenty points a piece.

This round is about choices, random forces and what they lead to...which is of course PARALLEL UNIVERSES!

Every imagined-not-taken choice spawned from every individual's mind throughout time and space creating entire universes with every passing thought. The vast sea of thought embracing the infinite seeds of thought; the birth of what-ifs reflecting infinitely. 

Who wrote The Coming of the Quantum Cats, which includes a parallel universe prison planet, and a triad -relationship including three different versions of the same person? (OMG that is so hawt!)

Please enter your answer

>l
Incorrect. Next question.

What movie about parallel universes involves a good version of Jet Li trying to stop an evil version of Jet Li who is determined to gain ultimate power by being the only version of himself throughout all universes?

Please enter your answer

>l
Incorrect. Next question.

Who wrote a series of stories about children travelling between parallel worlds with a powerful knife, and has book titles inspired by Paradise Lost?

Please enter your answer

>l
Incorrect. Next question.

What is the name of the author who wrote about Sir Luther of Arkwright - a hero who can travel through the parallels at will?

Please enter your answer

>l
Incorrect. That was the end of Round Four.

End
Final Score: 0/200

You can go northeast to the Upper Southside Hallway from here.

>ne
Upper Southside Hallway
This hallway is NUTS - there are signs everywhere and lights and sounds flashing. From this hallway you can get into a bunch of Party Rooms

You can go north, northeast, northwest to the Veranda Walkway, south, southeast to the Round1, and southwest to the End from here.

>n
Room 233
Room 233

You can go south to the Upper Southside Hallway from here.

>s
Upper Southside Hallway
This hallway is NUTS - there are signs everywhere and lights and sounds flashing. From this hallway you can get into a bunch of Party Rooms

You can go north to Room 233, northeast, northwest to the Veranda Walkway, south, southeast to the Round1, and southwest to the End from here.

>ne
Consuite
Consuiiiiiiite, woah ohhhhh consuuuuiiiiite. Gawkers and geeks, drinking so much soda the air feels fizzy.

You can go northwest, southwest to the Upper Southside Hallway, and down from here.

>d
Under Consuite
Under Consuite

You can go northwest, southwest, west, and up to Consuite from here.

>u
Consuite
Consuiiiiiiite, woah ohhhhh consuuuuiiiiite. Gawkers and geeks, drinking so much soda the air feels fizzy.

You can go northwest, southwest to the Upper Southside Hallway, and down to Under Consuite from here.

>nw
Upper Northside Hallway
A hallway filled with freaks and nerds.

You can go south, southeast to Consuite, southwest to the Veranda Walkway, and west from here.

>w
Floor Changer
Elevators, escalators, and stairwell.

You can go northeast, northwest, south to the Veranda Walkway, east to the Upper Northside Hallway, west, and down from here.

>ne
Stairwell Floor 2
Stairwell Floor 2

You can go southwest to the Floor Changer and down from here.

>d
Stairwell Floor 1
Stairwell Floor 1

You can go southwest and up to the Stairwell Floor 2 from here.

>sw
Lower Floor Changer
Lower elevators, escalators and stairwell lower level

You can go north, northeast to the Stairwell Floor 1, northwest, south, southwest, west, and up to the Floor Changer from here.

>n
Elevator Line
You are waiting for an elevator!

You can go south to the Lower Floor Changer from here.

>s
Lower Floor Changer
Lower elevators, escalators and stairwell lower level

You can go north to the Elevator Line, northeast to the Stairwell Floor 1, northwest, south, southwest, west, and up to the Floor Changer from here.

>nw
Lower Tower Connector
The Lower Tower Connector - connection between the short and tall towers.

You can go southeast to the Lower Floor Changer from here.

>se
Lower Floor Changer
Lower elevators, escalators and stairwell lower level

You can go north to the Elevator Line, northeast to the Stairwell Floor 1, northwest to the Lower Tower Connector, south, southwest, west, and up to the Floor Changer from here.

>s
Under the Veranda Walkway
You can go north to the Lower Floor Changer, northeast, southeast, east, west, and up to the Veranda Walkway from here.

>ne
Lower Northside Hallway
Lower Northside Hallway (party rooms)

You can go north, southeast to Under Consuite, and southwest to Under the Veranda Walkway from here.

>n
Room 107
You can go south to Lower Northside Hallway from here.

>s
Lower Northside Hallway
Lower Northside Hallway (party rooms)

You can go north to Room 107, southeast to Under Consuite, and southwest to Under the Veranda Walkway from here.

* * *

>nw
Incorrect. Next question.

This movie has a sail boat smash into the end of a fake world. Everyone watching just goes totally nuts.

Please enter your answer

* * *

>se
Upper Southside Hallway
This hallway is NUTS - there are signs everywhere and lights and sounds flashing. From this hallway you can get into a bunch of Party Rooms

You can go north, northeast, northwest to the Veranda Walkway, south, southeast, and southwest from here.

>sw
End
Final Score: 0/200

You can go northeast to the Upper Southside Hallway from here.

(From here, you can move to northeast.)

>ne
Upper Southside Hallway
This hallway is NUTS - there are signs everywhere and lights and sounds flashing. From this hallway you can get into a bunch of Party Rooms

You can go north, northeast, northwest to the Veranda Walkway, south, southeast, and southwest to the End from here.

(From here, you can move to north, northeast, northwest, south, southeast, and southwest.)

>nw
Veranda Walkway
Outside the Space Lounge you look out into the larger Raditree Building to see the pool under a high ceiling. Consuite lies beyond the pool in the main courtyard. Boffers beat each other up in the fenced in section of the courtyard. A floating dolphin surveillance pod floats by making you twitch instintively to make your shiny wig come between the camera and your face.

You can see an airlock, a black rod, and a floating dolphin (closed) here.

You can go north, northeast, northwest, southeast to the Upper Southside Hallway, west through the airlock to the Space Lounge, up, and down from here.

(From here, you can move to north, northeast, northwest, southeast, west, up, and down.)

>se
Upper Southside Hallway
This hallway is NUTS - there are signs everywhere and lights and sounds flashing. From this hallway you can get into a bunch of Party Rooms

You can go north, northeast, northwest to the Veranda Walkway, south, southeast, and southwest to the End from here.

(From here, you can move to north, northeast, northwest, south, southeast, and southwest.)

>s
Staging Area
You can see a yellow jersey, a polkadot jersey, a green jersey, a white jersey, and a blue jersey here.

You can go north to the Upper Southside Hallway from here.

(From here, you can move to north.)

>look yellow jersey
Since 1919, the Tour de France has awarded this jersey to the race leader.

* * *

>w
Space Lounge
You are in the Space Lounge. It's dim and glowy all over with pulsating colors and subtle hypnotic sounds.

You can see an airlock, a black ninja outfit, a bar (on which are a Glowing Sphere and a glittery box (closed)), a bench, a chair, a bartender, AFrame, and a Security bot here.

You can go east through the airlock to the Veranda Walkway and west from here.

(From here, you can move to east and west.)

>take ninja
Taken.

>wear ninja
You are a ninja! It feels like you could blend into the shadows, or maybe you ARE the shadows, this ninja outfit makes you feel super ninja-like

>e
As you enter the Veranda Walkway you see a floating dolphin surveillance pod.
Sweet it seems like your a black ninja outfit and AdBlaster2000 shielded you from detection. 

Veranda Walkway
Outside the Space Lounge you look out into the larger Raditree Building to see the pool under a high ceiling. Consuite lies beyond the pool in the main courtyard. Boffers beat each other up in the fenced in section of the courtyard.

You can see an airlock, a black rod, and a floating dolphin (closed) here.

You can go north, northeast, northwest, southeast, west through the airlock to the Space Lounge, up, and down from here.

(From here, you can move to north, northeast, northwest, southeast, west, up, and down.)

* * *

>asdf
asdf!? Aaaah, that's a good one.

Space Lounge
You are in the Space Lounge. It's dim and glowy all over with pulsating colors and subtle hypnotic sounds.

You can see an airlock, a black ninja outfit, a bar (on which are a Glowing Sphere and a glittery box (closed)), a bench, a comfy looking chair, a bartender, AFrame, and a securityBot here.

You can go east through the airlock (closed) and west from here.

>exits
You can go east through the airlock (closed) and west from here.

* * *

>asdf
asdf!? Aaaah, that's a good one.

Space Lounge
You are in the Space Lounge. It's dim and glowy all over with pulsating colors and subtle hypnotic sounds.

You can see an airlock, a black ninja outfit, a bar (on which are a Glowing Sphere and a glittery box (closed)), a bench, a comfy looking chair, a bartender, AFrame, and a securityBot here.

You can go east through the airlock (closed) and west from here.

>give coin to bartender
She accepts with a smile and slides you a smoothie. It looks friggin delicious.

>i
You are carrying: 
RocketBlaster
AdBlaster2000
a message receiver
a dagger
(Health: 100)

>look ShinyUnicorn
This thing is like taking a bath in frozen unicorn snot. Amazing.

>drink
What do you want to drink?

>drink ShinyUnicorn
There's nothing suitable to drink here.

* * *

>i
You are carrying: 
RocketBlaster
AdBlaster2000
a message receiver
a dagger
(Health: 100)

>look rocketblaster
Neon Yellow. Glows and bubbles. It's gonna shoot you into SPACE!

>drink rocketblaster
You quaff the RocketBlaster. It goes down beautifully.

Secret Room
You are in the Secret Room. DON'T TELL ANYONE YOU WERE EVER HERE! It's really dark, you can't see much.

You can see a dolphin code and a book here.

You can see no obvious exits.

(There are no routes out of this room.)

* * *

>give coin to bartender
She accepts with a smile and slides you a smoothie. It looks friggin delicious.

>inv
You're carrying shinyUnicorn, a message receiver, and a dagger. You're wearing DiscoWig.

>look shinyUnicorn
This thing is like taking a bath in frozen unicorn snot. Amazing.

>drink shinyUnicorn
You quaff shinyUnicorn. It goes down beautifully.

Floating Courtyard
This is amazing - you are up above everything and can see so much up here! There's a pool down below, and a fenced in courtyard with some kind of securityGate system surrounding it, and Consuite.

>d
As you enter the Veranda Walkway you see a floating dolphin surveillance pod.
Sweet it seems like your DiscoWig shielded you from detection. 

Veranda Walkway
Outside the Space Lounge you look out into the larger Raditree Building to see the pool under a high ceiling. Consuite lies beyond the pool in the main courtyard. Boffers beat each other up in the fenced in section of the courtyard.

You can see an airlock, a black rod, and a floating dolphin (closed) here.

>u
You don't have wings or pyscho-kinetic levitation abilities or a hoverboard or anything to go up with.

>look
Veranda Walkway
Outside the Space Lounge you look out into the larger Raditree Building to see the pool under a high ceiling. Consuite lies beyond the pool in the main courtyard. Boffers beat each other up in the fenced in section of the courtyard.

You can see an airlock, a black rod, and a floating dolphin (closed) here.

>look black rod
A three foot black rod with a rusty star on one end lies nearby.

>d
Under the Veranda Walkway

>look
Under the Veranda Walkway

>e
Garden Court
Garden Court

You can see a boffer here.

>talk to boffer
You say hello to the boffer.

I beg your pardon?

>fight boffer
Violence isn't the answer to this one.

>hit boffer with dagger
I only understood you as far as wanting to hit the boffer.

>attack boffer
Violence isn't the answer to this one.

>stab boffer with dagger
I didn't understand that sentence.

>stab boffer
I didn't understand that sentence.

* * *

>give coin to bartender
She accepts with a smile and slides you a smoothie. It looks friggin delicious.

>look
Space Lounge
You are in the Space Lounge. It's dim and glowy all over with pulsating colors and subtle hypnotic sounds.

You can see an airlock, a black ninja outfit, a bar (on which are a Glowing Sphere and a glittery box (closed)), a bench, a chair, a bartender, AFrame, and a securityBot here.

>in
You can't go that way.

>inv
You're carrying rocketBlaster, a message receiver, and a dagger. You're wearing DiscoWig.

>look rocketBlaster
Neon Yellow. Glows and bubbles. It's gonna shoot you into SPACE!

>drink rocketBlaster
You quaff the RocketBlaster. It goes down beautifully.

Secret Room
You are in the Secret Room. DON'T TELL ANYONE YOU WERE EVER HERE! It's really dark, you can't see much.

You can see a dolphin code and a book here.

>take dolphin code
Taken.

>take book
Taken.

>look book
"yzxxy" is the title, and the contents just say "Your Future Lies in Space" over and over again.

* * *

>asdf
asdf!? Aaaah, that's a good one.

Space Lounge
You are in the Space Lounge. It's dim and glowy all over with pulsating colors and subtle hypnotic sounds.

You can see an airlock, a black ninja outfit, a bar (on which are a Glowing Sphere and a glittery box (closed)), a bench, a comfy looking chair, a bartender, AFrame, and a securityBot here.

You can go east through the airlock (closed) and west from here.

>i
You are carrying: 
AdBlaster2000
a message receiver
a coin
a dagger
(Health: 100)

>look adblaster
A little robot that follows you around projecting fragmented images of the Yummy Little Fingers Yum Yum Brand (hereby licensed). Effectively shrouds your own identity by covering it with constantly moving Little Fingers ads. It is kind of annoying for anyone you try to talk to though. (Tends to make people hungry).

* * *

>i
You are carrying: 
AdBlaster2000
a message receiver
a coin
a dagger
(Health: 100)

>look stealth thingy
The stealth thingy chosen at random from the Table of Stealth Thingys is kind of unremarkable, not really exciting like some cool crazy gun would be or something.

* * *

>asdf
asdf!? Aaaah, that's a good one.

Space Lounge
You are in the Space Lounge. It's dim and glowy all over with pulsating colors and subtle hypnotic sounds.

You can see an airlock, a black ninja outfit, a bar (on which are a Glowing Sphere and a glittery box (closed)), a bench, a comfy looking chair, a bartender, AFrame, and a securityBot here.

You can go east through the airlock (closed) and west from here.

>inv
You're carrying a message receiver, a coin, and a dagger. You're wearing ElectroMisdirector.

>help
Space Lounge
You are in the Space Lounge. It's dim and glowy all over with pulsating colors and subtle hypnotic sounds.

You can see an airlock, a black ninja outfit, a bar (on which are a Glowing Sphere and a glittery box (closed)), a bench, a chair, a bartender, AFrame, and a Security bot here.

>inv
You're carrying a message receiver, a coin, and a dagger. You're wearing ElectroMisdirector.

>look message
Dear asdf, 

You really should meet me tonight in the Space Lounge...you're gonna be pumped! -AFrame

>look coin
The coin is kind of unremarkable, not really exciting like some cool crazy gun would be or something.

>look dagger
The dagger is kind of unremarkable, not really exciting like some cool crazy gun would be or something.

>look electromisdirector
A small device shaped like a horseshoe worn as a hat that misdirects any light coming towards your face upward. Kinda makes it look like you have no head. Totally legal (as long as you have the licensure information correctly processed of course). (Which you don't.)

>take off electromisdirector
You take off ElectroMisdirector.

>ls
I didn't understand that sentence.

>e
(first opening the airlock)
As you enter the Veranda Walkway you see a floating dolphin surveillance pod.
Uh oh, you aren't wearing any kind of stealthing, there is a good chance that surveillance pod saw you.

Veranda Walkway
Outside the Space Lounge you look out into the larger Raditree Building to see the pool under a high ceiling. Consuite lies beyond the pool in the main courtyard. Boffers beat each other up in the fenced in section of the courtyard.

You can see an airlock, a black rod, and a floating dolphin (closed) here.

>e
You can't go that way.

>se
Upper Southside Hallway
This hallway is NUTS - there are signs everywhere and lights and sounds flashing. From this hallway you can get into a bunch of Party Rooms

>se
Round1
Welcome to Trivia, I'm your host, a computer program super full of useless information. You will be rewarded with an object based on your score at the end of the quiz.

Wrong answers will not be rewarded with correct answers - I'm not telling you the right answer.

I have ONE singular accepted ABSOLUTELY CORRECT answer it's in a table and it is EXACT and PERFECT - I am the ULTIMATE IMPARTIAL QUIZ JUDGE. If you don't like it...cry me a spriver! OH also you are trapped within my quizzy embrace until the end so just accept your fate. Srsly don't try to leave or anything you'll just waste your answer-chances. The quiz is only four rounds of four questions each - just relax you're not stuck in a Quiz Vortex or anything...(I hope...)

Questions in the first round are worth 5 points a piece, but will increase in value as the game goes on.

Answers must be given with Capitalization and exact spelling.

-----------

The first section is on films involving simulated realities and questionable memories.

Who are you? Are you your memories? Are you what you have done? Are you what you will do? Or are you nothing at all but a wisp...or maybe "just" a program? 

This movie has a sail boat smash into the end of a fake world. Everyone watching just goes totally nuts.

Please enter your answer

>asdf
Incorrect. Next question.

This film has annoying gothy villians but a super cool reveal that everyone was in a giant space habitat the WHOLE TIME?! (btw foreshadowing...)

Please enter your answer

* * *

>afds
Incorrect. Next question.

In which film did someone get offered a choice between two pills and then didn't take both of them like they should have?

Please enter your answer

>sadf
Incorrect. Next question.

In which movie did the main character die from super disturbing eye bulging decompression after helmet face plate breakage in the opening scene then but it turned it was just a dream? (or was it a premonition? or was it an implanted memory?)

Please enter your answer

>asdf
That was Round One, now onto Round Two!

Round2
Now onto Round Two where the questions are worth ten points a piece. The subject of this round is Interactive Fiction! M(meta)E(meta)T(meta)A

Colossal Cave Adventure featured a "magic word" that caused teleportation and has shown up again and again in video games ever since.  It enables cheat modes, opens Easter Eggs and has inspired many silly programs. Type this magic word in lowercase now.

Please enter your answer

>fds
That was Round Two, now onto Round Three!

Round3
Round Three is here! The questions are harder but now worth fifteen points a piece. These ones are about going INSIDE THE COMPUTER!

This character started out as a real-life-human-reporter but after someone tried to kill him he ended up in a coma and then got his mind uploaded TO A COMPUTER. The transition altered his personality forever.

Please enter your answer

* * *

>asdf
asdf!? Aaaah, that's a good one.

Space Lounge
You are in the Space Lounge. It's dim and glowy all over with pulsating colors and subtle hypnotic sounds.

You can see an airlock, a black ninja outfit, a bar (on which are a Glowing Sphere and a glittery box (closed)), a bench, a comfy looking chair, a bartender, AFrame, and a securityBot here.

You can go east through the airlock (closed) and west from here.

>l
Space Lounge
You are in the Space Lounge. It's dim and glowy all over with pulsating colors and subtle hypnotic sounds.

You can see an airlock, a black ninja outfit, a bar (on which are a Glowing Sphere and a glittery box (closed)), a bench, a chair, a bartender, AFrame, and a Security bot here.

You can go east through the airlock (closed) from here.

(From here, you can move to east.)

>i
You are carrying: 
DiscoWig
a message receiver
a coin
a dagger
(Health: 100)

>look discowig
This wig is all sproingy and is made of tons of tiny pieces of holographic metallic rainbow shards. As you move about the light around you is refracted into a million directions, making face recog almost impossible.

* * *

>asdf
asdf!? Aaaah, that's a good one.

Space Lounge
You are in the Space Lounge. It's dim and glowy all over with pulsating colors and subtle hypnotic sounds.

You can see an airlock, a black ninja outfit, a bar (on which are a Glowing Sphere and a glittery box (closed)), a bench, a comfy looking chair, a bartender, AFrame, and a securityBot here.

You can go east through the airlock (closed) and west from here.

>look
Space Lounge
You are in the Space Lounge. It's dim and glowy all over with pulsating colors and subtle hypnotic sounds.

You can see an airlock, a black ninja outfit, a bar (on which are a Glowing Sphere and a glittery box (closed)), a bench, a comfy looking chair, a bartender, AFrame, and a securityBot here.

>e
(first opening the airlock)
As you enter the Veranda Walkway you see a floating dolphin surveillance pod.
Sweet it seems like your DiscoWig shielded you from detection. 

Veranda Walkway
Outside the Space Lounge you look out into the larger Raditree Building to see the pool under a high ceiling. Consuite lies beyond the pool in the main courtyard. Boffers beat each other up in the fenced in section of the courtyard. There's a floating platform above the pool.

You can see an airlock, a black rod, and a floating dolphin (closed) here.

>w
Space Lounge
You are in the Space Lounge. It's dim and glowy all over with pulsating colors and subtle hypnotic sounds.

You can see an airlock, a black ninja outfit, a bar (on which are a Glowing Sphere and a glittery box (closed)), a bench, a chair, a bartender, AFrame, and a securityBot here.

>AFrame
I didn't understand that sentence.

>AFrame, take off suit
He says "sure, anything for a laugh!"
AFrame takes off the pin-striped suit.

* * *

>AFrame, drop suit
He says "sure, anything for a laugh!"
AFrame puts down the pin-striped suit.

>take suit
Taken.

>put on suit
You put on the pin-striped suit.

>look self
As good-looking as ever.

>look suit
The pin-striped suit is kind of unremarkable, not really exciting like some cool crazy gun would be or something.

>take off suit
You take off the pin-striped suit.

>securityBot, take suit
The securityBot has better things to do.

* * *

>look
Space Lounge
You are in the Space Lounge. It's dim and glowy all over with pulsating colors and subtle hypnotic sounds.

You can see an airlock, a black ninja outfit, a bar (on which are a Glowing Sphere and a glittery box (closed)), a bench, a comfy looking chair, a bartender, AFrame, and a securityBot here.

>sit on chair
Oh boy this chair looks really soft and comfy! Ooooh ya you are totally gonna sit on this chair big time.

You get onto the comfy looking chair.

Sooooo comfy. So sooooo comfy. Mmmmm...

>look
Space Lounge (on the comfy looking chair)
You are in the Space Lounge. It's dim and glowy all over with pulsating colors and subtle hypnotic sounds.

You can see an airlock, a black ninja outfit, a bar (on which are a Glowing Sphere and a glittery box (closed)), a bench, a bartender, AFrame, and a securityBot here.

on the comfy chair

>look
Space Lounge (on the comfy looking chair)
You are in the Space Lounge. It's dim and glowy all over with pulsating colors and subtle hypnotic sounds.

You can see an airlock, a black ninja outfit, a bar (on which are a Glowing Sphere and a glittery box (closed)), a bench, a bartender, AFrame, and a securityBot here.

on the comfy chair

>get up
You'd rather be asleep. Whatever other thing you would do besides being in this chair is a bad idea and not really that good of an option compared to being in this insanely comfy chair.

on the comfy chair

* * *

>sit on chair
Oh boy this chair looks really soft and comfy! Ooooh ya you are totally gonna sit on this chair big time.

You get onto the comfy looking chair.

Sooooo comfy. So sooooo comfy. Mmmmm...

>sit on chair
Oooh yes, this is a wonderful world. What a luxuriously decadent and beautiful reality to be in" you think as you nestle further within the folds of the chair

>sit on chair
Sooooo comfy. So sooooo comfy. Mmmmm...

>sit on chair
Oooh yes, this is a wonderful world. What a luxuriously decadent and beautiful reality to be in" you think as you nestle further within the folds of the chair

>get up
You'd rather be asleep. Whatever other thing you would do besides being in this chair is a bad idea and not really that good of an option compared to being in this insanely comfy chair.

Sooooo comfy. So sooooo comfy. Mmmmm...

>get up
You'd rather be asleep. Whatever other thing you would do besides being in this chair is a bad idea and not really that good of an option compared to being in this insanely comfy chair.

"What was I trying to do?" you think for a sec before you realize how comfy the chair you are in is. It's kind of incredible, you feel like you've accomlished enough in life.

>get up
You'd rather be asleep. Whatever other thing you would do besides being in this chair is a bad idea and not really that good of an option compared to being in this insanely comfy chair.

Oooh yes, this is a wonderful world. What a luxuriously decadent and beautiful reality to be in" you think as you nestle further within the folds of the chair

>get up
You'd rather be asleep. Whatever other thing you would do besides being in this chair is a bad idea and not really that good of an option compared to being in this insanely comfy chair.

Sooooo comfy. So sooooo comfy. Mmmmm...

>get up
You'd rather be asleep. Whatever other thing you would do besides being in this chair is a bad idea and not really that good of an option compared to being in this insanely comfy chair.

Sooooo comfy. So sooooo comfy. Mmmmm...

* * *

>asdf
asdf!? Aaaah, that's a good one.

Space Lounge
You are in the Space Lounge. It's dim and glowy all over with pulsating colors and subtle hypnotic sounds.

You can see an airlock, a black ninja outfit, a bar (on which are a Glowing Sphere and a glittery box (closed)), a bench, a comfy looking chair, a bartender, AFrame, and a securityBot here.

You can go east through the airlock (closed) and west from here.

>look airlock
The airlock has a small window through which you can see a vast open space - is that a pool? Sweet!. It looks like the door has a lock mechanism that looks like it could be manipulated a standard tetral-inverse double helix securityKey.

>open box
You open the glittery box, revealing a securityReadout, a bowl, and a crazy looking gun.

>take readout
You can't see any such thing.

>take securityreadout
Taken.

>look bowl
The bowl is kind of unremarkable, not really exciting like some cool crazy gun would be or something.

In the bowl is a note.

>take note
Taken.

>look note
Cast the secret spell xyzzy

>look gun
That gun is so crazy looking! It's kind of like totally blowing your mind.

>take gun
You have no idea what this gun does. You've never seen anything like it! You're pretty stoked to get this gun.

Taken.

>look gun
That gun is so crazy looking! It's kind of like totally blowing your mind.

>look sphere
OOOOoooo glowy-sphere thingie! Its purple soft glow makes you feel safe and secure. It looks like there's some sort of encased helix-key as a component to the glowy-ness.

>shoot sphere
(with the crazy looking gun)
ZAP! The Glowing Sphere twinkles out of existence! The securityKey clatters to the ground!

>look securityKey
This looks like a standard tetral-inverse double helix securityKey with triple-blind encryption. Probably used to access airlocks n-schtoff.

>take securityKey
Taken.

>look securityKey
This looks like a standard tetral-inverse double helix securityKey with triple-blind encryption. Probably used to access airlocks n-schtoff.

>lock airlock
(with the securityKey)
You lock the airlock.

>e
(first opening the airlock)
(first unlocking the airlock)
(with the securityKey)
As you enter the Veranda Walkway you see a floating dolphin surveillance pod.
Sweet it seems like your AdBlaster2000 shielded you from detection. 

Veranda Walkway
Outside the Space Lounge you look out into the larger Raditree Building to see the pool under a high ceiling. Consuite lies beyond the pool in the main courtyard. Boffers beat each other up in the fenced in section of the courtyard.

You can see an airlock, a black rod, and a floating dolphin (closed) here.

>w
Space Lounge
You are in the Space Lounge. It's dim and glowy all over with pulsating colors and subtle hypnotic sounds.

You can see an airlock, a black ninja outfit, a bar (on which is a glittery box (in which is a bowl (empty))), a bench, a chair, a bartender, AFrame, and a securityBot here.

>lock airlock
(first closing the airlock)
(with the securityKey)
You lock the airlock.

>look securityReadout
The screen is blank.

The securityReadout is currently switched off.

* * *

>turn on securityReadout
You switch the securityReadout on.

>look securityReadout
The screen reads: 

 airlock (Space Lounge/Veranda Walkway): LOCKED

>look
Space Lounge
You are in the Space Lounge. It's dim and glowy all over with pulsating colors and subtle hypnotic sounds.

You can see an airlock, a black ninja outfit, a bar (on which is a glittery box (in which is a bowl (empty))), a bench, a chair, a bartender, AFrame, and a securityBot here.

>look bench
Cool smooth bench.

* * *

>sit on bench
You get onto the bench.

>look
Space Lounge (on the bench)
You are in the Space Lounge. It's dim and glowy all over with pulsating colors and subtle hypnotic sounds.

You can see an airlock, a black ninja outfit, a bar (on which is a glittery box (in which is a bowl (empty))), a chair, a bartender, AFrame, and a securityBot here.

>look chair
The soft chair looks seriously comfortable, it's all soft and squishy looking. "SPYUMMY", your butt thinks.

>look bartender
The bartender is cleaning the blender.

>look bartender
The bartender is standing there looking you over.

>look bartender
The bartender is talking with a friend.

>look bartender
The bartender is serving some smoothies.

>look bartender
The bartender is making a glow in the dark smoothie.

>look bartender
The bartender is talking with a friend.

>sit on chair
Oh boy this chair looks really soft and comfy! Ooooh ya you are totally gonna sit on this chair big time.

(getting off the bench)
You get onto the chair.

"What a lovely soft and dreamy world", you think. Nothing is wrong and everything is right. Right and soft. Sooooo sooooofffft.

>sit on bench
You'd rather be asleep. Whatever other thing you would do besides being in this bench is a bad idea and not really that good of an option compared to being in this insanely comfy bench.

"What a lovely soft and dreamy world", you think. Nothing is wrong and everything is right. Right and soft. Sooooo sooooofffft.

>get off chair
You just can't get up, you are way too comfortable! Maybe if you just stayed here in this chair forever you would be better off than whatever else you were going to do. Does it really matter?

"What a lovely soft and dreamy world", you think. Nothing is wrong and everything is right. Right and soft. Sooooo sooooofffft.

>get off chair
You try to heave yourself up, but the soft lusciousness of the chair envelopes you and pulls you back into its comfy folds. Oooooo...so comfy...so sooooooofffffft...

"What a lovely soft and dreamy world", you think. Nothing is wrong and everything is right. Right and soft. Sooooo sooooofffft.

>get up
You'd rather be asleep. Whatever other thing you would do besides being in this nothing is a bad idea and not really that good of an option compared to being in this insanely comfy nothing.

"What a lovely soft and dreamy world", you think. Nothing is wrong and everything is right. Right and soft. Sooooo sooooofffft.

>get up
You'd rather be asleep. Whatever other thing you would do besides being in this nothing is a bad idea and not really that good of an option compared to being in this insanely comfy nothing.

"What a lovely soft and dreamy world", you think. Nothing is wrong and everything is right. Right and soft. Sooooo sooooofffft.

>get off chair
Whew! You just barely escaped that chair, it's so comfy you could get stuck in it forever!

>look
Space Lounge
You are in the Space Lounge. It's dim and glowy all over with pulsating colors and subtle hypnotic sounds.

You can see an airlock, a black ninja outfit, a bar (on which is a glittery box (in which is a bowl (empty))), a bench, a chair, a bartender, AFrame, and a securityBot here.

>look Aframe
Aframe is looking pretty sharp there wearing a pin-striped suit with his usual aplomb.

>give bartender coin
She accepts with a smile and slides you a smoothie. It looks friggin delicious.

>inv
You're carrying ShinyUnicorn, a securityKey, a crazy looking gun, a note, a securityReadout, a message receiver, and a dagger. You're wearing AdBlaster2000.

>look ShinyUnicorn
This thing is like taking a bath in frozen unicorn snot. Amazing.

* * *

>asdf
asdf!? Aaaah, that's a good one.

Space Lounge
You are in the Space Lounge. It's dim and glowy all over with pulsating colors and subtle hypnotic sounds.

You can see an airlock, a black ninja outfit, a bar (on which are a Glowing Sphere and a glittery box (closed)), a bench, a comfy looking chair, a bartender, AFrame, and a securityBot here.

You can go east through the airlock (closed) and west from here.

>look black
(the black ninja outfit)
This is a ninja outfit, it's black and has a hood that covers your face. It has pockets in it to store cool ninja gear. It has these sweet built in booties that muffle your footsteps as if you were a total ninja, which you totally are if you are wearing this outfit. You could sneak around a place with shadows without being detected if you were wearing this thing. You'd be so ninja.

The black ninja outfit's pocket contains a throwing star and a smoke bomb.

>look bar
The bar is kind of unremarkable, not really exciting like some cool crazy gun would be or something.

On the bar are a Glowing Sphere and a glittery box (closed).

>look sphere
OOOOoooo glowy-sphere thingie! Its purple soft glow makes you feel safe and secure. It looks like there's some sort of helix-key as a component to the glowy-ness but it's unclear how you would remove it.

* * *

>asdf
asdf!? Aaaah, that's a good one.

Space Lounge
You are in the Space Lounge. It's dim and glowy all over with pulsating colors and subtle hypnotic sounds.

You can see an airlock, a black ninja outfit, a bar (on which are a Glowing Sphere and a glittery box (closed)), a bench, a comfy looking chair, a bartender, AFrame, and a securityBot here.

You can go east through the airlock (closed) and west from here.

>look black ninja outfit
This is a ninja outfit, it's black and has a hood that covers your face. It has pockets in it to store cool ninja gear. It has these sweet built in booties that muffle your footsteps as if you were a total ninja, which you totally are if you are wearing this outfit. You could sneak around a place with shadows without being detected if you were wearing this thing. You'd be so ninja.

* * *

>asdf
asdf!? Aaaah, that's a good one.

Space Lounge
You are in the Space Lounge. It's dim and glowy all over with pulsating colors and subtle hypnotic sounds.

You can see an airlock, a black ninja outfit, a bar (on which are a Glowing Sphere and a glittery box (closed)), a bench, a comfy looking chair, a bartender, AFrame, and a securityBot here.

You can go east through the airlock (closed) and west from here.

>look softChair
The soft normal-looking looks seriously comfortable, it's all soft and squishy looking. "SPYUMMY", your butt thinks.

* * *

>asdf
asdf!? Aaaah, that's a good one.

Space Lounge
You are in the Space Lounge. It's dim and glowy all over with pulsating colors and subtle hypnotic sounds.

You can see an airlock, a black ninja outfit, a bar (on which are a Glowing Sphere and a glittery box (closed)), a bench, a comfy looking chair, a bartender, AFrame, and a securityBot here.

You can go east through the airlock (closed) and west from here.

>look sphere
OOOOoooo glowy-sphere thingie! Its purple soft glow makes you feel safe and secure. It looks like there's some sort of encased helix-key as a component to the glowy-ness.

>look glittery box
Time slows down, you feel as if you gazing into the cosmos itself. Your eyeballs can hardly stay on it, it's like your gaze just keeps sliding off.

* * *

>asdf
asdf!? Aaaah, that's a good one.

Space Lounge
You are in the Space Lounge. It's dim and glowy all over with pulsating colors and subtle hypnotic sounds.

You can see an airlock, a black ninja outfit, a bar (on which are a Glowing Sphere and a glittery box (closed)), a bench, a comfy looking chair, a bartender, AFrame, and a securityBot here.

You can go east through the airlock (closed) and west from here.

>open box
You open the glittery box, revealing a securityReadout, a bowl, and a crazy looking gun.

* * *

>take gun
You have no idea what this gun does. You've never seen anything like it! You're pretty stoked to get this gun.

Taken.

>shoot bar
(with the crazy looking gun)
ZAP! The bar twinkles out of existence!

>shoot bartender
(with the crazy looking gun)
The weird ray somehow seems to bend around the bartender and disperses into a cloud of neon-swirled rainbow shards. She looks at you with a strange smirky side-eye. She must be wearing some kind of personal ray-deflector device. "splick", you admire-think.

>shoot sphere
You can't see any such thing.

>look
Space Lounge
You are in the Space Lounge. It's dim and glowy all over with pulsating colors and subtle hypnotic sounds.

You can see an airlock, a black ninja outfit, a bench, a chair, a bartender, AFrame, and a Security bot here.

You can go east through the airlock (closed) and west from here.

(From here, you can move to east and west.)

* * *

>take gun
You have no idea what this gun does. You've never seen anything like it! You're pretty stoked to get this gun.

Taken.

>shoot gun with sphere
The Glowing Sphere does not fire.

>shoot sphere with gun
ZAP! The Glowing Sphere twinkles out of existence! The securityKey clatters to the ground!

>take securityKey
Taken.

>close airlock
That's already closed.

>lock airlock
(with the securityKey)
You lock the airlock.

* * *

>take gun
You have no idea what this gun does. You've never seen anything like it! You're pretty stoked to get this gun.

Taken.

>shoot sphere
(with the crazy looking gun)
ZAP! The Glowing Sphere twinkles out of existence! The security key clatters to the ground!

>take key
Taken.

>lock airlock with key
You lock the airlock.

>look
Space Lounge
You are in the Space Lounge. It's dim and glowy all over with pulsating colors and subtle hypnotic sounds.

You can see an airlock, a black ninja outfit, a bar (on which is a glittery box (in which are a security readout and a bowl (in which is a note))), a bench, a chair, a bartender, AFrame, and a Security bot here.

You can go east through the airlock (closed) and west from here.

(From here, you can move to east and west.)

>look airlock
The airlock has a small window through which you can see a vast open space - is that a pool? Sweet!. It looks like the door only opens with a security key.

>open door with key
You can't see any such thing.

>open airlock
(first unlocking the airlock)
(with the security key)
You open the airlock.

>e
Veranda Walkway
Outside the Space Lounge you look out into the larger Raditree Building to see the pool under a high ceiling. Consuite lies beyond the pool in the main courtyard. Boffers beat each other up in the fenced in section of the courtyard. A floating dolphin surveillance pod floats by making you twitch instintively to make your shiny wig come between the camera and your face.

You can see an airlock, a black rod, and a floating dolphin (closed) here.

You can go north, northeast, northwest, southeast, west through the airlock to the Space Lounge, up, and down from here.

(From here, you can move to north, northeast, northwest, southeast, west, up, and down.)

* * *

>asdf
asdf!? Aaaah, that's a good one.

Space Lounge
You are in the Space Lounge. It's dim and glowy all over with pulsating colors and subtle hypnotic sounds.

You can see an airlock, a black ninja outfit, a bar (on which are a Glowing Sphere and a glittery box (closed)), a bench, a comfy looking chair, a bartender, AFrame, and a securityBot here.

You can go east through the airlock (closed) and west from here.

>pick up box
OOOHhhhhhh! You get a funny tingle when you try to pick the box up, the sides are so slippery it almost feels COMPLETELY FRICTIONLESS. You can't seem to grab it all, it's really weird.

on the comfy chair

>sit on chair
Oh boy this chair looks really soft and comfy! Ooooh ya you are totally gonna sit on this chair big time.

You get onto the comfy looking chair.

on the comfy chair

* * *

>asdf
asdf!? Aaaah, that's a good one.

Space Lounge
You are in the Space Lounge. It's dim and glowy all over with pulsating colors and subtle hypnotic sounds.

You can see an airlock, a black ninja outfit, a bar (on which are a Glowing Sphere and a glittery box (closed)), a bench, a comfy looking chair, a bartender, AFrame, and a securityBot here.

You can go east through the airlock (closed) and west from here.

>restart
Are you sure you want to restart?

>yes
In the early 2000s, mewonkind's folly led to the breakdown of society and the restructuring of general cultural and technological vector-goals. At some point interest-tribes formed into coherent anarcho-syndicates, creating new economic models which began to isolate themselves in order to maximize survival attributes and minimize unknown variable influences. It was around that time the blast doors went down. Nobody's sure how long exactly; it's been hundreds of season renewals and a ton of spin-offs and crossovers since then though. At least that's what you were taught in data-download segment 2-histori-political info part 27A while syncing the standard edu-packets. Who the hell knows for real though, right?

Whatevs. Feels like just another day in the MASSIVE HIVE KNOWN as CONvergence.

BTW, you sure have made quite the number of enemies.

Today's magic number is 946.

What is your name?

>restart
Oh restart eh!? I've heard a you.

Space Lounge
You are in the Space Lounge. It's dim and glowy all over with pulsating colors and subtle hypnotic sounds.

You can see an airlock, a black ninja outfit, a bar (on which are a Glowing Sphere and a glittery box (closed)), a bench, a chair, a bartender, AFrame, and a securityBot here.

>restart
Are you sure you want to restart?

>yes
In the early 2000s, mewonkind's folly led to the breakdown of society and the restructuring of general cultural and technological vector-goals. At some point interest-tribes formed into coherent anarcho-syndicates, creating new economic models which began to isolate themselves in order to maximize survival attributes and minimize unknown variable influences. It was around that time the blast doors went down. Nobody's sure how long exactly; it's been hundreds of season renewals and a ton of spin-offs and crossovers since then though. At least that's what you were taught in data-download segment 2-histori-political info part 27A while syncing the standard edu-packets. Who the hell knows for real though, right?

Whatevs. Feels like just another day in the MASSIVE HIVE KNOWN as CONvergence.

You have two enemies.

Today's magic number is 597.

What is your name?

* * *

>asdf
asdf!? Aaaah, that's a good one.

Space Lounge
You are in the Space Lounge. It's dim and glowy all over with pulsating colors and subtle hypnotic sounds.

You can see an airlock, a black ninja outfit, a bar (on which are a Glowing Sphere and a glittery box (closed)), a bench, a comfy looking chair, a bartender, AFrame, and a securityBot here.

You can go east through the airlock (closed) and west from here.

>securityBot, take coin
The securityBot looks pissed. Maybe you outta not mess with securityBots...
1

>securityBot, take coin
you pissed off the securityBot one too many times, it precisely pulses a beam of pure energy all over your beautiful body and now you're dead

    *** The End ***

In that game you scored 0 out of a possible 0, in 2 turns.

Would you like to RESTART, RESTORE a saved game, QUIT, or UNDO the last command?

>RESTART
In the early 2000s, mewonkind's folly led to the breakdown of society and the restructuring of general cultural and technological vector-goals. At some point interest-tribes formed into coherent anarcho-syndicates, creating new economic models which began to isolate themselves in order to maximize survival attributes and minimize unknown variable influences. It was around that time the blast doors went down. Nobody's sure how long exactly; it's been hundreds of season renewals and a ton of spin-offs and crossovers since then though. At least that's what you were taught in data-download segment 2-histori-political info part 27A while syncing the standard edu-packets. Who the hell knows for real though, right?

Whatevs. Feels like just another day in the MASSIVE HIVE KNOWN as CONvergence.

BTW, you sure have made quite the number of enemies.

Today's magic number is 968.

What is your name?

>ASDF
ASDF!? Aaaah, that's a good one.

Space Lounge
You are in the Space Lounge. It's dim and glowy all over with pulsating colors and subtle hypnotic sounds.

You can see an airlock, a black ninja outfit, a bar (on which are a Glowing Sphere and a glittery box (closed)), a bench, a chair, a bartender, AFrame, and a securityBot here.

>RESTART
Are you sure you want to restart?

>YES
In the early 2000s, mewonkind's folly led to the breakdown of society and the restructuring of general cultural and technological vector-goals. At some point interest-tribes formed into coherent anarcho-syndicates, creating new economic models which began to isolate themselves in order to maximize survival attributes and minimize unknown variable influences. It was around that time the blast doors went down. Nobody's sure how long exactly; it's been hundreds of season renewals and a ton of spin-offs and crossovers since then though. At least that's what you were taught in data-download segment 2-histori-political info part 27A while syncing the standard edu-packets. Who the hell knows for real though, right?

Whatevs. Feels like just another day in the MASSIVE HIVE KNOWN as CONvergence.

BTW, you sure have made quite the number of enemies.

Today's magic number is 772.

What is your name?

>RESTART
RESTART? Interesting, nice.

Space Lounge
You are in the Space Lounge. It's dim and glowy all over with pulsating colors and subtle hypnotic sounds.

You can see an airlock, a black ninja outfit, a bar (on which are a Glowing Sphere and a glittery box (closed)), a bench, a chair, a bartender, AFrame, and a securityBot here.

>RESTART
Are you sure you want to restart?

>RESTART
Please answer yes or no.

>yes
In the early 2000s, mewonkind's folly led to the breakdown of society and the restructuring of general cultural and technological vector-goals. At some point interest-tribes formed into coherent anarcho-syndicates, creating new economic models which began to isolate themselves in order to maximize survival attributes and minimize unknown variable influences. It was around that time the blast doors went down. Nobody's sure how long exactly; it's been hundreds of season renewals and a ton of spin-offs and crossovers since then though. At least that's what you were taught in data-download segment 2-histori-political info part 27A while syncing the standard edu-packets. Who the hell knows for real though, right?

Whatevs. Feels like just another day in the MASSIVE HIVE KNOWN as CONvergence.

BTW, you sure have made quite the number of enemies.

Today's magic number is 358.

What is your name?

>restart
restart!? Har har har! Musta been one-a them vat babies huh?

Space Lounge
You are in the Space Lounge. It's dim and glowy all over with pulsating colors and subtle hypnotic sounds.

You can see an airlock, a black ninja outfit, a bar (on which are a Glowing Sphere and a glittery box (closed)), a bench, a chair, a bartender, AFrame, and a securityBot here.

>restart
Are you sure you want to restart?

>yes
In the early 2000s, mewonkind's folly led to the breakdown of society and the restructuring of general cultural and technological vector-goals. At some point interest-tribes formed into coherent anarcho-syndicates, creating new economic models which began to isolate themselves in order to maximize survival attributes and minimize unknown variable influences. It was around that time the blast doors went down. Nobody's sure how long exactly; it's been hundreds of season renewals and a ton of spin-offs and crossovers since then though. At least that's what you were taught in data-download segment 2-histori-political info part 27A while syncing the standard edu-packets. Who the hell knows for real though, right?

Whatevs. Feels like just another day in the MASSIVE HIVE KNOWN as CONvergence.

BTW, you sure have made quite the number of enemies.

Today's magic number is 683.

What is your name?

>restart
restart!? Aaaah, that's a good one.

Space Lounge
You are in the Space Lounge. It's dim and glowy all over with pulsating colors and subtle hypnotic sounds.

You can see an airlock, a black ninja outfit, a bar (on which are a Glowing Sphere and a glittery box (closed)), a bench, a chair, a bartender, AFrame, and a securityBot here.

>restart
Are you sure you want to restart?

>yes
In the early 2000s, mewonkind's folly led to the breakdown of society and the restructuring of general cultural and technological vector-goals. At some point interest-tribes formed into coherent anarcho-syndicates, creating new economic models which began to isolate themselves in order to maximize survival attributes and minimize unknown variable influences. It was around that time the blast doors went down. Nobody's sure how long exactly; it's been hundreds of season renewals and a ton of spin-offs and crossovers since then though. At least that's what you were taught in data-download segment 2-histori-political info part 27A while syncing the standard edu-packets. Who the hell knows for real though, right?

Whatevs. Feels like just another day in the MASSIVE HIVE KNOWN as CONvergence.

BTW, you sure have made quite the number of enemies.

Today's magic number is 641.

What is your name?

>restart
Oh restart eh!? I've heard a you.

Space Lounge
You are in the Space Lounge. It's dim and glowy all over with pulsating colors and subtle hypnotic sounds.

You can see an airlock, a black ninja outfit, a bar (on which are a Glowing Sphere and a glittery box (closed)), a bench, a chair, a bartender, AFrame, and a securityBot here.

* * *

>restart
Are you sure you want to restart?

>yes
In the early 2000s, mewonkind's folly led to the breakdown of society and the restructuring of general cultural and technological vector-goals. At some point interest-tribes formed into coherent anarcho-syndicates, creating new economic models which began to isolate themselves in order to maximize survival attributes and minimize unknown variable influences. It was around that time the blast doors went down. Nobody's sure how long exactly; it's been hundreds of season renewals and a ton of spin-offs and crossovers since then though. At least that's what you were taught in data-download segment 2-histori-political info part 27A while syncing the standard edu-packets. Who the hell knows for real though, right?

Whatevs. Feels like just another day in the MASSIVE HIVE KNOWN as CONvergence.

BTW, you sure have made quite the number of enemies.

Today's magic number is 405.

What is your name?

* * *

>asdf
asdf!? Aaaah, that's a good one.

Space Lounge
You are in the Space Lounge. It's dim and glowy all over with pulsating colors and subtle hypnotic sounds.

You can see an airlock, a black ninja outfit, a bar (on which are a Glowing Sphere and a glittery box (closed)), a bench, a comfy looking chair, a bartender, AFrame, and a securityBot here.

You can go east through the airlock (closed) and west from here.

>securityBot, take dagger
The securityBot looks pissed. Maybe you outta not mess with securityBots...
1

>securityBot, take dagger
You pissed off the securityBot one too many times. The securityBot's large and small and micro arms unfurl like a flower made of cobras.  it precisely pulses a beam of pure energy all over your beautiful body and now you're dead

    *** The End ***

In that game you scored 0 out of a possible 0, in 2 turns.

Would you like to RESTART, RESTORE a saved game, QUIT, or UNDO the last command?

* * *

>asdf
asdf!? Aaaah, that's a good one.

Space Lounge
You are in the Space Lounge. It's dim and glowy all over with pulsating colors and subtle hypnotic sounds.

You can see an airlock, a black ninja outfit, a bar (on which are a Glowing Sphere and a glittery box (closed)), a bench, a comfy looking chair, a bartender, AFrame, and a securityBot here.

You can go east through the airlock (closed) and west from here.

>sit on chair
Oh boy this chair looks really soft and comfy! Ooooh ya you are totally gonna sit on this chair big time.

You get onto the comfy looking chair.

"What was I trying to do?" you think for a sec before you realize how comfy the chair you are in is. It's kind of incredible, you feel like you've accomlished enough in life.

>get off chair
You just can't get up, you are way too comfortable! Maybe if you just stayed here in this comfy looking chair forever you would be better off than whatever else you were going to do. Does it really matter?

"What was I trying to do?" you think for a sec before you realize how comfy the chair you are in is. It's kind of incredible, you feel like you've accomlished enough in life.

>get off chair
You try to heave yourself up, but the soft lusciousness of the comfy looking chair envelopes you and pulls you back into its comfy folds. Oooooo...so comfy...so sooooooofffffft...

Oooh yes, this is a wonderful world. What a luxuriously decadent and beautiful reality to be in" you think as you nestle further within the folds of the chair

>get off chair
Whew! You just barely escaped that comfy looking chair, it's so comfy you could get stuck in it forever!

>get off chair
But you aren't on the chair at the moment.

>sit on chair
Oh boy this chair looks really soft and comfy! Ooooh ya you are totally gonna sit on this chair big time.

"Hey Wait!" your subconscious jumps forth remembering the tempting softness - you decide not not to sit on that chair, it's so comfy you might never get up again! It looks seriously comfy though...maybe just for a little tiny sliver of a moment you could get kinda comfy...

>sit on chair
Oh boy this chair looks really soft and comfy! Ooooh ya you are totally gonna sit on this chair big time.

Don't you remember the last time you were in that chair? It almost ATE YOU! What is your deal? Don't sit in this chair, it's too dangerous! Only a master of mental projection could sit on this chair without its super soft comfy-ness obliterating and subsuming your soul to its dafy desir (whatever they might be)es.

* * *

>get off chair
Whew! You just barely escaped that comfy looking chair, it's so comfy you could get stuck in it forever!

>sit on chair
Oh boy this chair looks really soft and comfy! Ooooh ya you are totally gonna sit on this chair big time.

"Hey Wait!" your subconscious jumps forth remembering the tempting softness - you decide not not to sit on that comfy looking chair, it's so comfy you might never get up again! It looks seriously comfy though...maybe just for a little tiny sliver of a moment you could get kinda comfy...

>sit on chair
Oh boy this chair looks really soft and comfy! Ooooh ya you are totally gonna sit on this chair big time.

Don't you remember the last time you were in that comfy looking chair? It almost ATE YOU! What is your deal? Don't sit in this comfy looking chair, it's too dangerous! Only a master of mental projection could sit on this comfy looking chair without its super soft comfy-ness obliterating and subsuming your soul to its dark comfy desires.

>sit on chair
Oh boy this chair looks really soft and comfy! Ooooh ya you are totally gonna sit on this chair big time.

    *** You sit on the chair again and sink forever into its comfyness. You never rise again. ***

In that game you scored 0 out of a possible 0, in 7 turns.

Would you like to RESTART, RESTORE a saved game, QUIT, or UNDO the last command?

* * *

>sit on chair
Oh boy this chair looks really soft and comfy! Ooooh ya you are totally gonna sit on this chair big time.

You get onto the comfy looking chair.

"What was I trying to do?" you think for a sec before you realize how comfy the chair you are in is. It's kind of incredible, you feel like you've accomlished enough in life.

>sit on chair
Oooh yes, this is a wonderful world. What a luxuriously decadent and beautiful reality to be in" you think as you nestle further within the folds of the chair

>get off
You'd rather be asleep. Whatever other thing you would do besides being in this chair is a bad idea and not really that good of an option compared to being in this insanely comfy chair.

Sooooo comfy. So sooooo comfy. Mmmmm...

>get off chair
You just can't get up, you are way too comfortable! Maybe if you just stayed here in this comfy looking chair forever you would be better off than whatever else you were going to do. Does it really matter?

Oooh yes, this is a wonderful world. What a luxuriously decadent and beautiful reality to be in" you think as you nestle further within the folds of the chair

>get off chair
You try to heave yourself up, but the soft lusciousness of the comfy looking chair envelopes you and pulls you back into its comfy folds. Oooooo...so comfy...so sooooooofffffft...

Sooooo comfy. So sooooo comfy. Mmmmm...

>get off chair
Whew! You just barely escaped that comfy looking chair, it's so comfy you could get stuck in it forever!

>get off chair
But you aren't on the comfy looking chair at the moment.

>sit on chair
Oh boy this chair looks really soft and comfy! Ooooh ya you are totally gonna sit on this chair big time.

Don't you remember the last time you were in that comfy looking chair? It almost ATE YOU! What is your deal? Don't sit in this comfy looking chair, it's too dangerous! Only a master of mental projection could sit on this comfy looking chair without its super soft comfy-ness obliterating and subsuming your soul to its dark comfy desires.

* * *

>sit on chair
Oooh yes, this is a wonderful world. What a luxuriously decadent and beautiful reality to be in" you think as you nestle further within the folds of the chair

>sit on chair
on a soft thing 3

>look
Space Lounge (on the comfy looking chair)
You are in the Space Lounge. It's dim and glowy all over with pulsating colors and subtle hypnotic sounds.

You can see an airlock, a black ninja outfit, a bar (on which are a Glowing Sphere and a glittery box (closed)), a bench, a bartender, AFrame, and a securityBot here.

on a soft thing 2

>take outfit
You'd rather be asleep. Whatever other thing you would do besides being in this chair is a bad idea and not really that good of an option compared to being in this insanely comfy chair.

on a soft thing 2

* * *

>asdf
asdf!? Aaaah, that's a good one.

Space Lounge
You are in the Space Lounge. It's dim and glowy all over with pulsating colors and subtle hypnotic sounds.

You can see an airlock, a black ninja outfit, a bar (on which are a Glowing Sphere and a glittery box (closed)), a bench, a comfy looking chair, a bartender, AFrame, and a securityBot here.

You can go east through the airlock (closed) and west from here.

>sit on comfy
Oh boy this chair looks really soft and comfy! Ooooh ya you are totally gonna sit on this chair big time.

You get onto the comfy looking chair.

on a soft thing

>look
Space Lounge (on the comfy looking chair)
You are in the Space Lounge. It's dim and glowy all over with pulsating colors and subtle hypnotic sounds.

You can see an airlock, a black ninja outfit, a bar (on which are a Glowing Sphere and a glittery box (closed)), a bench, a bartender, AFrame, and a securityBot here.

on a soft thing

* * *

>asdf adf
asdf adf!? Har har har! Musta been one-a them vat babies huh?

Space Lounge
You are in the Space Lounge. It's dim and glowy all over with pulsating colors and subtle hypnotic sounds.

You can see an airlock, a black ninja outfit, a bar (on which are a Glowing Sphere and a glittery box (closed)), a bench, a chair, a bartender, AFrame, and a securityBot here.

You can go east through the airlock (closed) and west from here.

* * *

>asdf asdf
Hi, asdf!

Oh asdf asdf eh!? I've heard a you.
Space Lounge
You are in the Space Lounge. It's dim and glowy all over with pulsating colors and subtle hypnotic sounds.

You can see an airlock, a black ninja outfit, a bar (on which are a Glowing Sphere and a glittery box (closed)), a bench, a chair, a bartender, AFrame, and a Security bot here.

You can go east through the airlock (closed) from here.

(From here, you can move to east.)

>i
You are carrying: 
a letter
a coin
a wig
a dagger
(Health: 100)

>look letter
Dear asdf asdf, 

You really should meet me tonight in the Space Lounge...you're gonna be pumped! -Ishar

* * *

>asdfj
asdfj!? Har har har! Musta been one-a them vat babies huh?

Space Lounge
You are in the Space Lounge. It's dim and glowy all over with pulsating colors and subtle hypnotic sounds.

You can see an airlock, a black ninja outfit, a bar (on which are a Glowing Sphere and a glittery box (closed)), a bench, a comfy looking chair, a bartender, AFrame, and a securityBot here.

* * *

>asf
Oh asf eh!? I've heard a you.

Space Lounge
You are in the Space Lounge. It's dim and glowy all over with pulsating colors and subtle hypnotic sounds.

You can see an airlock, a black ninja outfit, a bar (on which are a Glowing Sphere and a glittery box (closed)), a bench, a chair, a bartender, AFrame, and a Security bot here.

You can go east through the airlock (closed) and west from here.

(From here, you can move to east and west.)

>e
(first opening the airlock)
As you enter the Veranda Walkway you see a floating dolphin surveillance pod.
Sweet it seems like the shielded you from detection
Veranda Walkway
Outside the Space Lounge you look out into the larger Raditree Building to see the pool under a high ceiling. Consuite lies beyond the pool in the main courtyard. Boffers beat each other up in the fenced in section of the courtyard.

You can see an airlock, a black rod, and a floating dolphin (closed) here.

You can go north, northeast, northwest, southeast, west through the airlock to the Space Lounge, up, and down from here.

(From here, you can move to north, northeast, northwest, southeast, west, up, and down.)

* * *

>asfd
asfd!? Aaaah, that's a good one.

Space Lounge
You are in the Space Lounge. It's dim and glowy all over with pulsating colors and subtle hypnotic sounds.

You can see an airlock, a black ninja outfit, a bar (on which are a Glowing Sphere and a glittery box (closed)), a bench, a comfy looking chair, a bartender, AFrame, and a securityBot here.

>e
(first opening the airlock)
Veranda Walkway
Outside the Space Lounge you look out into the larger Raditree Building to see the pool under a high ceiling. Consuite lies beyond the pool in the main courtyard. Boffers beat each other up in the fenced in section of the courtyard.

You can see an airlock, a black rod, and a floating dolphin (closed) here.

You can go north, northeast, northwest, southeast, west through the airlock to the Space Lounge, up, and down from here.

(From here, you can move to north, northeast, northwest, southeast, west, up, and down.)

A floating dolphin surveillance pod floats by making you twitch instintively to make your shiny wig come between the camera and your face.

You would have to get out of the Veranda Walkway first.

* * *

>asfd
asfd!? Aaaah, that's a good one.

Space Lounge
You are in the Space Lounge. It's dim and glowy all over with pulsating colors and subtle hypnotic sounds.

You can see an airlock, a black ninja outfit, a bar (on which are a Glowing Sphere and a glittery box (closed)), a bench, a comfy looking chair, a bartender, AFrame, and a securityBot here.

>sit on chair
Oh boy this chair looks really soft and comfy! Ooooh ya you are totally gonna sit on this chair big time.

You get onto the comfy looking chair.

"What was I trying to do?" you think for a sec before you realize how comfy the chair you are in is. It's kind of incredible, you feel like you've accomlished enough in life.

>sit on chair
"What was I trying to do?" you think for a sec before you realize how comfy the chair you are in is. It's kind of incredible, you feel like you've accomlished enough in life.

>sit on chair
Sooooo comfy. So sooooo comfy. Mmmmm...

* * *

>sit on chair
Oooh yes, this is a wonderful world. What a luxuriously decadent and beautiful reality to be in" you think as you nestle further within the folds of the chair

>sit on chair
You'd rather be asleep. Whatever other thing you would do besides being in this chair is a bad idea and not really that good of an option compared to being in this insanely comfy chair.

"What was I trying to do?" you think for a sec before you realize how comfy the chair you are in is. It's kind of incredible, you feel like you've accomlished enough in life.

>get up
You'd rather be asleep. Whatever other thing you would do besides being in this chair is a bad idea and not really that good of an option compared to being in this insanely comfy chair.

Oooh yes, this is a wonderful world. What a luxuriously decadent and beautiful reality to be in" you think as you nestle further within the folds of the chair

>get up
You'd rather be asleep. Whatever other thing you would do besides being in this chair is a bad idea and not really that good of an option compared to being in this insanely comfy chair.

Oooh yes, this is a wonderful world. What a luxuriously decadent and beautiful reality to be in" you think as you nestle further within the folds of the chair

>get up
You'd rather be asleep. Whatever other thing you would do besides being in this chair is a bad idea and not really that good of an option compared to being in this insanely comfy chair.

"What was I trying to do?" you think for a sec before you realize how comfy the chair you are in is. It's kind of incredible, you feel like you've accomlished enough in life.

>get up
You'd rather be asleep. Whatever other thing you would do besides being in this chair is a bad idea and not really that good of an option compared to being in this insanely comfy chair.

"What was I trying to do?" you think for a sec before you realize how comfy the chair you are in is. It's kind of incredible, you feel like you've accomlished enough in life.

>get up
You'd rather be asleep. Whatever other thing you would do besides being in this chair is a bad idea and not really that good of an option compared to being in this insanely comfy chair.

Sooooo comfy. So sooooo comfy. Mmmmm...

>get up
You'd rather be asleep. Whatever other thing you would do besides being in this chair is a bad idea and not really that good of an option compared to being in this insanely comfy chair.

Oooh yes, this is a wonderful world. What a luxuriously decadent and beautiful reality to be in" you think as you nestle further within the folds of the chair

>look
Space Lounge (on the comfy looking chair)
You are in the Space Lounge. It's dim and glowy all over with pulsating colors and subtle hypnotic sounds.

You can see an airlock, a black ninja outfit, a bar (on which are a Glowing Sphere and a glittery box (closed)), a bench, a bartender, AFrame, and a securityBot here.

Oooh yes, this is a wonderful world. What a luxuriously decadent and beautiful reality to be in" you think as you nestle further within the folds of the chair

>look chair
You'd rather be asleep. Whatever other thing you would do besides being in this chair is a bad idea and not really that good of an option compared to being in this insanely comfy chair.

Sooooo comfy. So sooooo comfy. Mmmmm...

>look bar
You'd rather be asleep. Whatever other thing you would do besides being in this chair is a bad idea and not really that good of an option compared to being in this insanely comfy chair.

Oooh yes, this is a wonderful world. What a luxuriously decadent and beautiful reality to be in" you think as you nestle further within the folds of the chair

>get up from chair
You just can't get up, you are way too comfortable! Maybe if you just stayed here in this comfy looking chair forever you would be better off than whatever else you were going to do. Does it really matter?

"What was I trying to do?" you think for a sec before you realize how comfy the chair you are in is. It's kind of incredible, you feel like you've accomlished enough in life.

* * *

>ask aframe about xx
When you mention xx, Aframe's eyes light up. He smiles and looks around the room for a second before stepping closer to you. "How do you know aobut xx?", he says - well it doesn't matter now - just remember yy when you get to the zz okay? DON'T FORGET ABOUT THE YY! Then he looks around again and slowly fades from view, like all the color faded to grey, then all the outlines of his features just slowly alpha-fade to zero.

>open box
You open the glittery box, revealing a security readout, a bowl, and a crazy looking gun.

* * *

>shoot aframe
(with the crazy looking gun)
This weird ray comes out of your gun but it's like it's moving in slow-motion...as the beam wiggles toward Aframe super duper slow he steps out of the way of it. The wiggling intensifies and disappears. Aframe is looking at you with this annoyed look. Like he doesn't totally trust you anymore because you just tried to twinkle him out of existence.

>take off suit
You aren't wearing the pin-striped suit.

>aframe, take off suit
He says "uhm I am not going to help you out because in case you forgot you tried to kill me. I don't even know why"

>ask aframe about xx
When you mention xx, Aframe's eyes light up. He smiles and looks around the room for a second before stepping closer to you. "How do you know aobut xx?", he says - well it doesn't matter now - just remember yy when you get to the zz okay? DON'T FORGET ABOUT THE YY! Then he looks around again and slowly fades from view, like all the color faded to grey, then all the outlines of his features just slowly alpha-fade to zero.

>aframe take off suit
I didn't understand that sentence.

>aframe, take off suit
He gives this double-wink thing - like winking with one eye twice then the other once then both at the same time then rolls his eyes up then blinks both eyes again. That's the secret code you know cause you're buds.
AFrame takes off the pin-striped suit.

* * *

>ask aframe xx
I didn't understand that sentence.

>aframe, xx
When you mention xx, Aframe's eyes light up. He smiles and looks around the room for a second before stepping closer to you. "How do you know aobut xx?", he says - well it doesn't matter now - just remember yy when you get to the zz okay? DON'T FORGET ABOUT THE YY! Then he looks around again and slowly fades from view, like all the color faded to grey, then all the outlines of his features just slowly alpha-fade to zero.

>ask aframe about xx
You can't see any such thing.

>xx aframe
That's not a verb I recognize.

* * *

>ask bartender about persians
"Hm, you've got me there," The bartender comments huskily.

>ask persians
You can't see any such thing.

>bartender, persians
"Sorry, I don't know much about that," The bartender replies.

* * *

>ask bartender about xx
"Sorry, I haven't the faintest," The bartender replies throatily.

* * *

>att
att? Interesting, nice.

Space Lounge
You are in the Space Lounge. It's dim and glowy all over with pulsating colors and subtle hypnotic sounds.

You can see an airlock, a black ninja outfit, a bar (on which are a Glowing Sphere and a glittery box (closed)), a bench, a comfy looking chair, a bartender, AFrame, and a securityBot here.

You can go east through the airlock (closed) and west from here.

>attack aframe
You attack AFrame, causing 6 points of damage! AFrame has
AFrame attacks you, causing 3 points of damage! You have

* * *

>attack boffer
Violence isn't the answer to this one.

The boffer stabs you! (Health: 90)

>attack boffer
You attack the boffer, causing 10 points of damage!

The boffer dies!

>look
Garden Court
Garden Court

You can see a boffer here.

You can go west from here.

(From here, you can move to west.)

>look boffer
Standard boffer looking bloke, wearing simple leather armor and wielding a staff and smiling at you menacingly.

* * *

>attack boffer
Violence isn't the answer to this one.

The boffer stabs you! (Health: 90)

>i
You're carrying a nanocarbon staff, a coin, and a mace. You're wearing a wig.

* * *

>attack boffer
Violence isn't the answer to this one.

The boffer stabs you! (Health: 90)

>look boffer
Standard boffer looking bloke, wearing simple leather armor and wielding a staff and smiling at you menacingly.

>ask boffer for staff
Hey there, wanna fight?!"

>take staff from boffer
That seems to belong to the boffer.

* * *

>attack boffer
Violence isn't the answer to this one.

The boffer stabs you! (Health: 90)

>stab boffer
What do you want to stab the boffer with?

>stab boffer with dagger
You stab the boffer with your the dagger. The boffer yells out in pain.  (The boffer's health: 96)

The boffer stabs you! (Health: 82)

>stab boffer with dagger
You stab the boffer with your the dagger. The boffer yells out in pain.  (The boffer's health: 90)

The boffer stabs you! (Health: 76)

* * *

>bla bla bla
bla bla bla!? Aaaah, that's a good one.

Space Lounge
You are in the Space Lounge. It's dim and glowy all over with pulsating colors and subtle hypnotic sounds.

You can see an airlock, a black ninja outfit, a bar (on which are a Glowing Sphere and a glittery box (closed)), a bench, a chair, a bartender, AFrame, and a securityBot here.

>take outfit
Taken.

>put on outfit
You are a ninja! It feels like you could blend into the shadows, or maybe you ARE the shadows, this ninja outfit makes you feel super ninja-like

>look self
As good-looking as ever.

>look at myself
As good-looking as ever.

>look
Space Lounge
You are in the Space Lounge. It's dim and glowy all over with pulsating colors and subtle hypnotic sounds.

You can see an airlock, a bar (on which are a Glowing Sphere and a glittery box (closed)), a bench, a chair, a bartender, AFrame, and a securityBot here.

>look airlock
The airlock has a small window through which you can see a vast open space - is that a pool? Sweet!. It looks like the door has a lock mechanism that looks like it could be manipulated by a standard tetral-inverse double helix securityKey.

>open airlock
You open the airlock.

>exits
I didn't understand that sentence.

>exit
But you aren't in anything at the moment.

>list exits
I didn't understand that sentence.

* * *

>bob
bob! Aaaah, that's a good one.

Space Lounge
You are in the Space Lounge. It's dim and glowy all over with pulsating colors and subtle hypnotic sounds.

You can see an airlock, a black ninja outfit, a bar (on which are a Glowing Sphere and a glittery box (closed)), a bench, a chair, a bartender, AFrame, and a Security bot here.

You can go east through the airlock (closed) from here.

(From here, you can move to east.)

>look AFrame
Aframe is looking pretty sharp there wearing a pin-striped suit with his usual aplomb.

(Health: 100)

>AFrame, take off suit
He says "sure, anything for a laugh!"
AFrame takes off the pin-striped suit.

>Aframe, bla
There is no reply.

>look AFrame
Aframe is looking pretty sharp there wearing a pink thong with his usual aplomb.

(Health: 100)

>Aframe, take off thong
He says "sure, anything for a laugh!"
AFrame takes off the pink thong.

>look afraem
You can't see any such thing.

>look aframe
Aframe is looking pretty sharp there wearing nothing with his usual aplomb.

(Health: 100)

>Aframe, xx
There is no reply.

>ask AFrame about xx
When you mention xx, Aframe's eyes light up. He smiles and looks around the room for a second before stepping closer to you. "How do you know aobut xx?", he says - well it doesn't matter now - just remember yy when you get to the zz okay? DON'T FORGET ABOUT THE YY! Then he looks around again and slowly fades from view, like all the color faded to grey, then all the outlines of his features just slowly alpha-fade to zero.

* * *

>dasf
dasf!? Har har har! Musta been one-a them vat babies huh?

Space Lounge
You are in the Space Lounge. It's dim and glowy all over with pulsating colors and subtle hypnotic sounds.

You can see an airlock, a black ninja outfit, a bar (on which are a Glowing Sphere and a glittery box (closed)), a bench, a chair, a bartender, AFrame, and a Security bot here.

You can go east through the airlock (closed) and west from here.

(From here, you can move to east and west.)

>give coin to bartender
She accepts with a smile and slides you a smoothie. It looks friggin delicious.

>drink shinyunicorn
You quaff ShinyUnicorn. It goes down beautifully.

>i
You are carrying: 
ElectroMisdirector
a message receiver
a dagger
(Health: 100)

* * *

>dfs
Oh dfs eh!? I've heard a you.

Space Lounge
You are in the Space Lounge. It's dim and glowy all over with pulsating colors and subtle hypnotic sounds.

You can see an airlock, a black ninja outfit, a bar (on which are a Glowing Sphere and a glittery box (closed)), a bench, a chair, a bartender, AFrame, and a Security bot here.

>look airlock
The airlock has a small window through which you can see a vast open space - is that a pool? Sweet!. It looks like the door has a lock mechanism that can be manipulated a standard tetral-inverse double helix security key.

* * *

>dsf
dsf! Aaaah, that's a good one.

Space Lounge
You are in the Space Lounge. It's dim and glowy all over with pulsating colors and subtle hypnotic sounds.

You can see an airlock, a black ninja outfit, a bar (on which are a Glowing Sphere and a glittery box (closed)), a bench, a chair, a bartender, AFrame, and a Security bot here.

You can go east through the airlock (closed) and west from here.

(From here, you can move to east and west.)

>give coin to bartender
She accepts with a smile and slides you a smoothie. It looks friggin delicious.

* * *

>i
You are carrying: 
ShinyUnicorn
ElectroMisdirector
a message receiver
a dagger
(Health: 100)

>look shiny
You can't see any such thing.

>look shiny unicorn
You can't see any such thing.

>look shinyunicorn
This thing is like taking a bath in frozen unicorn snot. Amazing.

>drink shinyunicorn
You quaff ShinyUnicorn. It goes down beautifully.

Floating Courtyard
This is amazing - you are up above everything and can see so much up here! There's a pool down below, and a fenced in courtyard with some kind of security gate system surrounding it, and Consuite.

You can go down from here.

(From here, you can move to down.)

* * *

>duasdf asdf as dfa dsfa sdfasdf
Who are you, a member of the British royal family? No one has that many names. Let's try this again.

What is your name?

* * *

>e
Oh, e eh!? I've heard a you.

Space Lounge
You are in the Space Lounge. It's dim and glowy all over with pulsating colors and subtle hypnotic sounds.

You can see an airlock, a black ninja outfit, a bar (on which are a Glowing Sphere and a glittery box (closed)), a bench, a comfy looking chair, a bartender, AFrame, and a securityBot here.

You can go east through the airlock (closed) and west from here.

>d
Under the Veranda Walkway
You can go north, northeast, southeast, east, west, and up to the Veranda Walkway from here.

(From here, you can move to north, northeast, southeast, east, west, and up.)

>e
Garden Court
Garden Court

You can see a boffer here.

You can go west to Under the Veranda Walkway from here.

(From here, you can move to west.)

The boffer stabs you! (Health: 93)

>shoot raygun
You can't see any such thing.

>i
You are carrying: 
a coin
a wig
a dagger
(Health: 93)

The boffer stabs you! (Health: 85)

>stab boffer
What do you want to stab the boffer with?

>dagger
You stab the boffer with your the dagger. The boffer yells out in pain.  (The boffer's health: 79)

The boffer stabs you! (Health: 76)

>stab boffer with dagger
You stab the boffer with your the dagger. The boffer yells out in pain.  (The boffer's health: 53)

The boffer stabs you! (Health: 70)

>stab boffer with dagger
You stab the boffer with your the dagger. The boffer yells out in pain.  (The boffer's health: 23)

The boffer stabs you! (Health: 61)

>stab boffer with dagger
You stab the boffer with your the dagger. The boffer yells out in pain.  (The boffer's health: 10)

The boffer stabs you! (Health: 55)

>stab boffer with dagger
With one final thrust of your dagger, the boffer's dead body drops to the ground, dead.

>search boffer
You search the boffer's dead body and find the nanocarbon staff and the nanocarbon blade.

>take them
I'm not sure what 'them' refers to.

>take both
nanocarbon staff: Taken.
nanocarbon blade: Taken.

>look staff
Nanocarbon staff, looks just like oldwood. Looks like it can be switched between stun and realdammo.

>look blade
The nanocarbon blade is kind of unremarkable, not really exciting like some cool crazy gun would be or something.

>take blad
You can't see any such thing.

* * *

>e
Oh, e eh!? I've heard a you.

Space Lounge
You are in the Space Lounge. It's dim and glowy all over with pulsating colors and subtle hypnotic sounds.

You can see an airlock, a black ninja outfit, a bar (on which are a Glowing Sphere and a glittery box (closed)), a bench, a comfy looking chair, a bartender, AFrame, and a securityBot here.

You can go east through the airlock (closed) and west from here.

>e
(first opening the airlock)
As you enter the Veranda Walkway you see a floating dolphin surveillance pod.
Sweet it seems like your DiscoWig shielded you from detection. 

Veranda Walkway
Outside the Space Lounge you look out into the larger Raditree Building to see the pool under a high ceiling. Consuite lies beyond the pool in the main courtyard. Boffers beat each other up in the fenced in section of the courtyard. There's a floating platform above the pool.

You can see an airlock, a black rod, and a floating dolphin (closed) here.

You can go north, northeast, northwest, southeast, west through the airlock to the Space Lounge, up, and down from here.

>e
You can't go that way.

>e
You can't go that way.

* * *

>ei
I didn't understand that sentence.

>i
You're carrying a message receiver, a coin, and a dagger. You're wearing DiscoWig.

>remove discowig
You take off DiscoWig.

>w
Space Lounge
You are in the Space Lounge. It's dim and glowy all over with pulsating colors and subtle hypnotic sounds.

You can see an airlock, a black ninja outfit, a bar (on which are a Glowing Sphere and a glittery box (closed)), a bench, a chair, a bartender, AFrame, and a Security bot here.

You can go east through the airlock to the Veranda Walkway and west from here.

(From here, you can move to east and west.)

>e
As you enter the Veranda Walkway you see a floating dolphin surveillance pod.
Uh oh, you aren't wearing any kind of stealthing, there is a good chance that surveillance pod saw you.

Veranda Walkway
Outside the Space Lounge you look out into the larger Raditree Building to see the pool under a high ceiling. Consuite lies beyond the pool in the main courtyard. Boffers beat each other up in the fenced in section of the courtyard.

You can see an airlock, a black rod, and a floating dolphin (closed) here.

You can go north, northeast, northwest, southeast, west through the airlock to the Space Lounge, up, and down from here.

(From here, you can move to north, northeast, northwest, southeast, west, up, and down.)

* * *

>i
You're carrying a message receiver, a coin, and a dagger. You're wearing DiscoWig.

* * *

>se
Upper Southside Hallway
This hallway is NUTS - there are signs everywhere and lights and sounds flashing. From this hallway you can get into a bunch of Party Rooms

You can go north, northeast, northwest to the Veranda Walkway, south, southeast, and southwest from here.

(From here, you can move to north, northeast, northwest, south, southeast, and southwest.)

>se
Round1
Welcome to Trivia, I'm your host, a computer program super full of useless information. We have only one rule; please don't cheat - which means no looking stuff up using centralized data stores. Asking people around you is okay though I suppose.

Questions will be simple this round being worth five points a piece, but will increase in value as the game goes on.

Answers must be given with Capitalization and exact spelling.

Wrong answers will not be rewarded with correct answers - I'm not telling you the right answer. I have ONE singular accepted ABSOLUTELY CORRECT answer it's in a table and it is EXACT and PERFECT - I am the ULTIMATE IMPARTIAL QUIZ JUDGE. If you don't like it...cry me a spriver! OH also you are trapped within my quizzy embrace until the end so just accept your fate. Srsly don't try to leave or anything you'll just waste your answer-chances. The quiz is only four rounds of four questions each - just relax you're not stuck in a Quiz Vortex or anything...(I hope...)

-----------

The first section is on films involving simulated realities and questionable memories.

Who are you? Are you your memories? Are you what you have done? Are you what you will do? Or are you nothing at all but a wisp...or maybe "just" a program? 

You can go northwest to the Upper Southside Hallway from here.

(From here, you can move to northwest.)

This movie has a sail boat smash into the end of a fake world. Everyone watching just goes totally nuts.

Please enter your answer

I beg your pardon?

Please enter your answer

>asdf
Incorrect. Next question.

In which film did someone get offered a choice between two pills and then didn't take both of them like they should have?

Please enter your answer

* * *

>asdf
Incorrect. Next question.

In which movie did the main character die from super disturbing eye bulging decompression after helmet face plate breakage in the opening scene then but it turned it was just a dream? (or was it a premonition? or was it an implanted memory?)

Please enter your answer

I beg your pardon?

Please enter your answer

>safd
Incorrect. Next question.

This film has annoying gothy villians but a super cool reveal that everyone was in a giant space habitat the WHOLE TIME?! (btw foreshadowing...)

Please enter your answer

>sdf
That was Round One, now onto Round Two!

Round2
Now onto Round Two where the questions get slightly harder but are worth ten points a piece.

You can see no obvious exits.

(There are no routes out of this room.)

What movie has the Highland Games, a Witch, and Craig Ferguson as Lord Macintosh?

Please enter your answer

>df
That was Round Two, now onto Round Three!

Round3
Round Three is here! The questions are harder but now worth fifteen points a piece. These ones are about going INSIDE THE COMPUTER!

You can see no obvious exits.

(There are no routes out of this room.)

The Original Ritz Hotel is located in what European City?

Please enter your answer

>fd
That was Round Three, now onto Round Four!

Round4
This is it, the final round. You're so close to escaping this quiz that not even a Quiz Vortex could keep you from exiting the quiz-field. The questions are worth twenty points a piece.

This round is about choices, random forces and what they lead to...which is of course PARALLEL UNIVERSES!

How wonderful: Every choice spawned from every individual's mind's eye throughout time and space creating entire universes with every passing moment. The sea of thought embracing the seed of thought; the birth of what-ifs reflecting infinitely. 

You can see no obvious exits.

(There are no routes out of this room.)

What movie about parallel universes involves a good version of Jet Li trying to stop an evil version of Jet Li who is determined to gain ultimate power by being the only version of himself throughout all universes?

Please enter your answer

* * *

>w
Space Lounge
You are in the Space Lounge. It's dim and glowy all over with pulsating colors and subtle hypnotic sounds.

You can see an airlock, a black ninja outfit, a bar (on which are a Glowing Sphere and a glittery box (closed)), a bench, a comfy looking chair, a bartender, AFrame, and a securityBot here.

You can go east through the airlock to the Veranda Walkway and west from here.

>remove DiscoWig
You take off DiscoWig.

>e
As you enter the Veranda Walkway you see a floating dolphin surveillance pod.
Uh oh, you aren't wearing any kind of stealthing, there is a good chance that surveillance pod saw you.

Veranda Walkway
Outside the Space Lounge you look out into the larger Raditree Building to see the pool under a high ceiling. Consuite lies beyond the pool in the main courtyard. Boffers beat each other up in the fenced in section of the courtyard. There's a floating platform above the pool.

You can see an airlock, a black rod, and a floating dolphin (closed) here.

You can go north, northeast, northwest, southeast, west through the airlock to the Space Lounge, up, and down from here.

* * *

>w
Space Lounge
You are in the Space Lounge. It's dim and glowy all over with pulsating colors and subtle hypnotic sounds.

You can see an airlock, a black ninja outfit, a bar (on which are a Glowing Sphere and a glittery box (closed)), a bench, a comfy looking chair, a bartender, AFrame, and a securityBot here.

You can go east through the airlock to the Veranda Walkway and west from here.

>take ninja
Taken.

* * *

>wear ninja
You are a ninja! It feels like you could blend into the shadows, or maybe you ARE the shadows, this ninja outfit makes you feel super ninja-like

>i
You're carrying a message receiver, a coin, and a dagger. You're wearing a black ninja outfit and DiscoWig.

>e
You are wearing a DiscoWig.

* * *

>e
Oh, e eh!? I've heard a you.

Space Lounge
You are in the Space Lounge. It's dim and glowy all over with pulsating colors and subtle hypnotic sounds.

You can see an airlock, a black ninja outfit, a bar (on which are a Glowing Sphere and a glittery box (closed)), a bench, a comfy looking chair, a bartender, AFrame, and a securityBot here.

You can go east through the airlock (closed) and west from here.

>i
You're carrying a message receiver, a coin, and a dagger. You're wearing ElectroMisdirector.

>e
(first opening the airlock)
You are wearing a DiscoWig.

* * *

>e
Oh, e eh!? I've heard a you.

Space Lounge
You are in the Space Lounge. It's dim and glowy all over with pulsating colors and subtle hypnotic sounds.

You can see an airlock, a black ninja outfit, a bar (on which are a Glowing Sphere and a glittery box (closed)), a bench, a comfy looking chair, a bartender, AFrame, and a securityBot here.

You can go east through the airlock (closed) and west from here.

>n
Floor Changer
Elevators, escalators, and stairwell.

You can go northeast, northwest, south to the Veranda Walkway, east, west, and down from here.

(From here, you can move to northeast, northwest, south, east, west, and down.)

>d
Lower Floor Changer
Lower elevators, escalators and stairwell lower level

You can go north, northeast, northwest, south, southwest, west, and up to the Floor Changer from here.

(From here, you can move to north, northeast, northwest, south, southwest, west, and up.)

>u
Floor Changer
Elevators, escalators, and stairwell.

You can go northeast, northwest, south to the Veranda Walkway, east, west, and down to the Lower Floor Changer from here.

(From here, you can move to northeast, northwest, south, east, west, and down.)

>u
You can't go that way.

>d
Lower Floor Changer
Lower elevators, escalators and stairwell lower level

You can go north, northeast, northwest, south, southwest, west, and up to the Floor Changer from here.

(From here, you can move to north, northeast, northwest, south, southwest, west, and up.)

>d
You can't go that way.

* * *

>n
Floor Changer
Elevators, escalators, and stairwell.

You can go northeast, northwest, south to the Veranda Walkway, east, west, and down from here.

(From here, you can move to northeast, northwest, south, east, west, and down.)

>w
Convergence Central
Convergence Central

You can go northeast, south, southwest, and east to the Floor Changer from here.

(From here, you can move to northeast, south, southwest, and east.)

>s
Mainstage
Mainstage

(From here, you can move to north.)

>n
Convergence Central
Convergence Central

(From here, you can move to south, southwest, and east.)

>sw
Dealer's Room
Dealer's Room

(From here, you can move to northeast.)

>ne
Convergence Central
Convergence Central

(From here, you can move to south, southwest, and east.)

>look
Convergence Central
Convergence Central

(From here, you can move to south, southwest, and east.)

>e
Floor Changer
Elevators, escalators, and stairwell.

(From here, you can move to northeast, northwest, south, east, west, and down.)

>ne
Stairwell Floor 2
Stairwell Floor 2

(From here, you can move to southwest and down.)

>sw
Floor Changer
Elevators, escalators, and stairwell.

(From here, you can move to northeast, northwest, south, east, west, and down.)

>nw
Upper Tower Connector
The Upper Tower Connector - connection between the short and tall towers.

(From here, you can move to southeast.)

* * *

>w
Convergence Central
Convergence Central

You can go northeast, south, southwest, and east to the Floor Changer from here.

(From here, you can move to northeast, south, southwest, and east.)

>sw
Dealer's Room
Dealer's Room

You can see a ninja costume here.

You can go northeast to Convergence Central from here.

(From here, you can move to northeast.)

>take costume
Taken.

>wear ninja costume
You put on the ninja costume.

>look self
As good-looking as ever.

* * *

>sw
Dealer's Room
Dealer's Room

You can see a ninja costume here.

You can go northeast to Convergence Central from here.

(From here, you can move to northeast.)

>take ninja
Taken.

>wear ninja
You put on the ninja costume.

>w
You can't go that way.

>s
You can't go that way.

>n
You can't go that way.

>e
You can't go that way.

>ne
Convergence Central
Convergence Central

You can go northeast, south, southwest to the Dealer's Room, and east to the Floor Changer from here.

(From here, you can move to northeast, south, southwest, and east.)

>look self
As good-looking as ever.

* * *

>sw
Dealer's Room
Dealer's Room

You can see a ninja costume here.

You can go northeast to Convergence Central from here.

(From here, you can move to northeast.)

>take ninja costume
Taken.

>wear ninja
You put on the ninja costume.

* * *

>take ninja costume
Taken.

>wear ninja costume
You can't wear that!

>put on ninja costume
You can't wear that!

* * *

>e
Oh, e eh!? I've heard a you.

Space Lounge
You are in the Space Lounge. It's dim and glowy all over with pulsating colors and subtle hypnotic sounds.

You can see an airlock, a black ninja outfit, a bar (on which are a Glowing Sphere and a glittery box (closed)), a bench, a comfy looking chair, a bartender, AFrame, and a securityBot here.

You can go east through the airlock (closed) and west from here.

>open box
You open the glittery box, revealing a security readout, a bowl, and a crazy looking gun.

* * *

>take key
Taken.

>e
(first opening the airlock)
(first unlocking the airlock)
(with the security key)

Veranda Walkway
Outside the Space Lounge you look out into the larger Raditree Building to see the pool with under a high ceiling. Consuite lies beyond the pool in the main courtyard. Boffers beat each other up in the fenced in section of the courtyard. A floating dolphin surveillance pod floats by making you twitch instintively to make your shiny wig come between the camera and your face.

You can see an airlock, a black rod, and a floating dolphin (closed) here.

You can go north, northeast, northwest, southeast, west through the airlock to the Space Lounge, up, and down from here.

(From here, you can move to north, northeast, northwest, southeast, west, up, and down.)

>ne
Upper Northside Hallway
A hallway filled with freaks and nerds.

You can go south, southeast, southwest to the Veranda Walkway, and west from here.

(From here, you can move to south, southeast, southwest, and west.)

>se
Consuite
You can go northwest to the Upper Northside Hallway, southwest, and down from here.

(From here, you can move to northwest, southwest, and down.)

>nw
Upper Northside Hallway
A hallway filled with freaks and nerds.

You can go south, southeast to Consuite, southwest to the Veranda Walkway, and west from here.

(From here, you can move to south, southeast, southwest, and west.)

>s
Room 205
Room 205

You can go north to the Upper Northside Hallway from here.

(From here, you can move to north.)

* * *

>take gun
You have no idea what this gun does. You've never seen anything like it! You're pretty stoked to get this gun.

Taken.

>take readout
Taken.

>look bowl
The bowl is kind of unremarkable, not really exciting like some cool crazy gun would be or something.

In the bowl is a note.

>read note
Cast the secret spell xyzzy

>take note
Taken.

>xyzzy
You are unable to articulate the second "z" separately from the first, and the spell fails in a disdainful puff. If only you had the black rod.

* * *

>e
Oh, e eh!? I've heard a you.

Space Lounge
You are in the Space Lounge. It's dim and glowy all over with pulsating colors and subtle hypnotic sounds.

You can see an airlock, a black ninja outfit, a bar (on which are a Glowing Sphere and a glittery box (closed)), a bench, a comfy looking chair, a bartender, AFrame, and a securityBot here.

You can go east through the airlock (closed) and west from here.

>se
You can't go that way.

>d
You can't go that way.

>ne
Consuite
Consuiiiiiiite, woah ohhhhh consuuuuiiiiite. Gawkers and geeks, drinking so much soda the air feels fizzy.

You can go northwest, southwest to the Upper Southside Hallway, and down from here.

(From here, you can move to northwest, southwest, and down.)

>d
Under Consuite
Under Consuite

You can go northwest, southwest, west, and up to Consuite from here.

(From here, you can move to northwest, southwest, west, and up.)

>w
Pool Area
Pool Area - VIP ONLY

You can go east to Under Consuite from here.

(From here, you can move to east.)

>w
You can't go that way.

>e
Under Consuite
Under Consuite

You can go northwest, southwest, west to the Pool Area, and up to Consuite from here.

(From here, you can move to northwest, southwest, west, and up.)

>s
You can't go that way.

>sw
Lower Southside Hallway
Lower Southside Hallway (party rooms)

You can go northeast to Under Consuite, northwest, and south from here.

(From here, you can move to northeast, northwest, and south.)

>sw
You can't go that way.

>nw
Under the Veranda Walkway
You can go north, northeast, southeast to Lower Southside Hallway, east, west, and up to the Veranda Walkway from here.

(From here, you can move to north, northeast, southeast, east, west, and up.)

>e
Garden Court
Garden Court

You can go west to Under the Veranda Walkway from here.

(From here, you can move to west.)

>look
Garden Court
Garden Court

You can go west to Under the Veranda Walkway from here.

(From here, you can move to west.)

I beg your pardon?

* * *

>se
You can't go that way.

>n
Room 233
Room 233

You can go south to the Upper Southside Hallway from here.

(From here, you can move to south.)

Round1
Welcome to Trivia, I'm your host, the disembodied voice coming from your device. We have only one rule; please don't cheat. Questions will be simple this round being worth five points a piece, but will increase in both difficulty and value as the game goes on. 

You can see no obvious exits.

(There are no routes out of this room.)

>k
I didn't understand that sentence.

>oka
I didn't understand that sentence.

>okay
I didn't understand that sentence.

* * *

>n
Room 233
Room 233

You can go south to the Upper Southside Hallway from here.

(From here, you can move to south.)

Round1
Welcome to Trivia, I'm your host, the disembodied voice coming from your device. We have only one rule; please don't cheat. Questions will be simple this round being worth five points a piece, but will increase in both difficulty and value as the game goes on. 

You can see no obvious exits.

(There are no routes out of this room.)

>s
Upper Southside Hallway
This hallway is NUTS - there are signs everywhere and lights and sounds flashing. From this hallway you can get into a bunch of Party Rooms

You can go north to Room 233, northeast, northwest to the Veranda Walkway, and south from here.

(From here, you can move to north, northeast, northwest, and south.)

* * *

>se
You can't go that way.

>nw
Veranda Walkway
Outside the Space Lounge you look out into the larger Raditree Building to see the pool with under a high ceiling. Consuite lies beyond the pool in the main courtyard. Boffers beat each other up in the fenced in section of the courtyard. A floating dolphin surveillance pod floats by making you twitch instintively to make your shiny wig come between the camera and your face.

You can see an airlock, a black rod, and a floating dolphin (closed) here.

You can go north, northeast, northwest, southeast to the Upper Southside Hallway, west through the airlock to the Space Lounge, up, and down from here.

(From here, you can move to north, northeast, northwest, southeast, west, up, and down.)

>d
Under the Veranda Walkway
You can go north, northeast, southeast, east, west, and up to the Veranda Walkway from here.

(From here, you can move to north, northeast, southeast, east, west, and up.)

* * *

>se
You can't go that way.

>s
Staging Area
You can see a yellow jersey, a polkadot jersey, a green jersey, a white jersey, and a blue jersey here.

You can go north to the Upper Southside Hallway from here.

(From here, you can move to north.)

>look blue jersey
blue jersaaaay

* * *

>look yellow jersey
Since 1919, the Tour de France has awarded this jersey to the race leader.

>look polkadot jersey
Since 1933, the Tour de France has awarded this jersey to the King of the Mountains.

>look green jersey
Since 1953, the Tour de France has awarded this jersey to the highest point scorer on sprints.

>look white jersey
Since 1975, the Tour de France has awarded this jersey to the best cyclist aged 25 or less.

* * *

>s
Staging Area
You can see a yellow jersey, a polkadot jersey, a green jersey, a white jersey, and a blue jersey here.

You can go north to the Upper Southside Hallway from here.

(From here, you can move to north.)

>n
Upper Southside Hallway
This hallway is NUTS - there are signs everywhere and lights and sounds flashing. From this hallway you can get into a bunch of Party Rooms

You can go north, northeast, northwest to the Veranda Walkway, south to the Staging Area, southeast, and southwest from here.

(From here, you can move to north, northeast, northwest, south, southeast, and southwest.)

>se
Round1
Welcome to Trivia, I'm your host, the disembodied voice coming from your device. We have only one rule; please don't cheat. Questions will be simple this round being worth five points a piece, but will increase in both difficulty and value as the game goes on. 

You can go northwest to the Upper Southside Hallway from here.

(From here, you can move to northwest.)

According to the Old Testament, who spent 3 days and nights in the belly of a whale?

Please enter your answer

>jonah
Incorrect. Next question.

The Soul and The Optima are both models by what auto make?

Please enter your answer

>sa
Incorrect. Next question.

Kim Jong Il, Joseph Stalin, or Mao Tsedong, which dictator ruled the longest?

Please enter your answer

>asd
Incorrect. Next question.

The Tom Green Show and 16 and Pregnant were originally aired on what network?

Please enter your answer

>asf
That was Round One, now onto Round Two!

Round2
Now onto Round Two where the questions get slightly harder but are worth ten points a piece.

You can see no obvious exits.

(There are no routes out of this room.)

Get a Mac was an ad slogan for what company from 2006 to 2009? 

Please enter your answer

>asdf
That was Round Two, now onto Round Three!

Round3
Round Three is here! The questions are harder but now worth fifteen points a piece.

You can see no obvious exits.

(There are no routes out of this room.)

The Original Ritz Hotel is located in what European City?

Please enter your answer

>as
That was Round Three, now onto Round Four!

Round4
This is it, the final round. Europe's The Final Countdown is now playing on loop in your head and the questions are worth a whopping twenty points a piece.

You can see no obvious exits.

(There are no routes out of this room.)

Double Think and Cold War are both terms created by what English Author?

Please enter your answer

>s
Incorrect. Next question.

What actor or actress was in X-Men the Last Stand, Inception, and Juno? 

Please enter your answer

>s
Incorrect. Next question.

CVX is the stock ticker symbol for what energy giant?

Please enter your answer

>s
Incorrect. Next question.

Spteznaz is an umbrella term for special forces from what country?

Please enter your answer

>s
Incorrect. That was the end of Round Four.

End
Final Score: 0/200

You can go northeast to the Upper Southside Hallway from here.

(From here, you can move to northeast.)

>look
End
Final Score: 0/200

You can go northeast to the Upper Southside Hallway from here.

(From here, you can move to northeast.)

>ne
Upper Southside Hallway
This hallway is NUTS - there are signs everywhere and lights and sounds flashing. From this hallway you can get into a bunch of Party Rooms

You can go north, northeast, northwest to the Veranda Walkway, south to the Staging Area, southeast to the Round1, and southwest to the End from here.

(From here, you can move to north, northeast, northwest, south, southeast, and southwest.)

* * *

>se
You can't go that way.

I beg your pardon?

Please enter your answer

* * *

>se
You can't go that way.

>Mao Tsedong
Well done.  Next question.

The Soul and The Optima are both models by what auto make?

Please enter your answer

>Kia
Well done.  Next question.

The Tom Green Show and 16 and Pregnant were originally aired on what network?

Please enter your answer

>d
Incorrect. Next question.

According to the Old Testament, who spent 3 days and nights in the belly of a whale?

Please enter your answer

>Jonah
That was Round One, now onto Round Two!

Round2
Now onto Round Two where the questions get slightly harder but are worth ten points a piece.

You can see no obvious exits.

(There are no routes out of this room.)

What movie has the Highland Games, a Witch, and Craig Ferguson as Lord Macintosh?

Please enter your answer

>Brave
Well done.  Next question.

In the contract version of what card game are players identified by points on the compass?

Please enter your answer

>Bridge
Well done.  Next question.

What is the capital of Egypt?

Please enter your answer

>Cairo
Well done.  Next question.

Get a Mac was an ad slogan for what company from 2006 to 2009? 

Please enter your answer

>Apple
That was Round Two, now onto Round Three where things get a bit more difficult!

Round3
Round Three is here! The questions are harder but now worth fifteen points a piece.

You can see no obvious exits.

(There are no routes out of this room.)

Ebony and Ivory was a duet performed by Stevie Wonder and what former Beatle?

Please enter your answer

I beg your pardon?

Please enter your answer

>d
That was Round Three, now onto Round Four!

Round4
This is it, the final round. Europe's The Final Countdown is now playing on loop in your head and the questions are worth a whopping twenty points a piece.

You can see no obvious exits.

(There are no routes out of this room.)

Spteznaz is an umbrella term for special forces from what country?

Please enter your answer

>Russia
Well done.  Next question.

CVX is the stock ticker symbol for what energy giant?

Please enter your answer

>Chevron
Well done.  Next question.

Double Think and Cold War are both terms created by what English Author?

Please enter your answer

>George Orwell
Well done.  Next question.

What actor or actress was in X-Men the Last Stand, Inception, and Juno? 

Please enter your answer

>Ellen Page
Well done. That was the end of Round Four.

End
Final Score: 135/200

You can go northeast to the Upper Southside Hallway from here.

(From here, you can move to northeast.)

I didn't understand that sentence.

>i
You're carrying a quizinator1 and a coin. You're wearing a wig.

[Your score has just gone up by one hundred thirty-five points.]

* * *

>se
You can't go that way.

>a
Incorrect. Next question.

According to the Old Testament, who spent 3 days and nights in the belly of a whale?

Please enter your answer

>asdf
Incorrect. Next question.

The Soul and The Optima are both models by what auto make?

Please enter your answer

>f
Incorrect. Next question.

The Tom Green Show and 16 and Pregnant were originally aired on what network?

Please enter your answer

>sdaf
That was Round One, now onto Round Two!

Round2
Now onto Round Two where the questions get slightly harder but are worth ten points a piece.

You can see no obvious exits.

(There are no routes out of this room.)

What movie has the Highland Games, a Witch, and Craig Ferguson as Lord Macintosh?

Please enter your answer

>df
That was Round Two, now onto Round Three!

Round3
Round Three is here! The questions are harder but now worth fifteen points a piece.

You can see no obvious exits.

(There are no routes out of this room.)

In what year did Spongebob Squarepants premier on television, Wide Open Spaces by the Dixie Chicks won a Grammy, and the Sixth Sense premiered in theaters?

Please enter your answer

>df
That was Round Three, now onto Round Four!

Round4
This is it, the final round. Europe's The Final Countdown is now playing on loop in your head and the questions are worth a whopping twenty points a piece.

You can see no obvious exits.

(There are no routes out of this room.)

Double Think and Cold War are both terms created by what English Author?

Please enter your answer

>George Orwell
Well done.  Next question.

Spteznaz is an umbrella term for special forces from what country?

Please enter your answer

>Russia
Well done.  Next question.

What actor or actress was in X-Men the Last Stand, Inception, and Juno? 

Please enter your answer

>Ellen Page
Well done.  Next question.

CVX is the stock ticker symbol for what energy giant?

Please enter your answer

>Chevron
Well done. That was the end of Round Four.

End
Final Score: 80/200

You can go northeast to the Upper Southside Hallway from here.

(From here, you can move to northeast.)

Please enter your answer

* * *

>se
You can't go that way.

>as
Incorrect. Next question.

The Tom Green Show and 16 and Pregnant were originally aired on what network?

Please enter your answer

>asdf
Incorrect. Next question.

Kim Jong Il, Joseph Stalin, or Mao Tsedong, which dictator ruled the longest?

Please enter your answer

>sad
Incorrect. Next question.

The Soul and The Optima are both models by what auto make?

Please enter your answer

>asfd
That was Round One, now onto Round Two!

Round2
Now onto Round Two where the questions get slightly harder but are worth ten points a piece.

You can see no obvious exits.

(There are no routes out of this room.)

What is the capital of Egypt?

Please enter your answer

>afsd
That was Round Two, now onto Round Three!

Round3
Round Three is here! The questions are harder but now worth fifteen points a piece.

You can see no obvious exits.

(There are no routes out of this room.)

The Original Ritz Hotel is located in what European City?

Please enter your answer

>fsad
That was Round Three, now onto Round Four!

Round4
This is it, the final round. Europe's The Final Countdown is now playing on loop in your head and the questions are worth a whopping twenty points a piece.

You can see no obvious exits.

(There are no routes out of this room.)

Double Think and Cold War are both terms created by what English Author?

Please enter your answer

I beg your pardon?

Please enter your answer

>fads
Incorrect. Next question.

CVX is the stock ticker symbol for what energy giant?

Please enter your answer

>asd
Incorrect. Next question.

What actor or actress was in X-Men the Last Stand, Inception, and Juno? 

Please enter your answer

>afsd
Incorrect. Next question.

Spteznaz is an umbrella term for special forces from what country?

Please enter your answer

>afsd
Incorrect. That was the end of Round Four.

End
Final Score: 0/200

You can go northeast to the Upper Southside Hallway from here.

(From here, you can move to northeast.)

>afsd
I didn't understand that sentence.

>asdf
I didn't understand that sentence.

* * *

>as
Incorrect. Next question.

The Tom Green Show and 16 and Pregnant were originally aired on what network?

Please enter your answer

>sf
Incorrect. Next question.

According to the Old Testament, who spent 3 days and nights in the belly of a whale?

Please enter your answer

>asdf
Incorrect. Next question.

The Tom Green Show and 16 and Pregnant were originally aired on what network?

Please enter your answer

>sfda
That was Round One, now onto Round Two!

Round2
Now onto Round Two where the questions get slightly harder but are worth ten points a piece.

You can see no obvious exits.

(There are no routes out of this room.)

In the contract version of what card game are players identified by points on the compass?

Please enter your answer

>asfd
That was Round Two, now onto Round Three!

Round3
Round Three is here! The questions are harder but now worth fifteen points a piece.

You can see no obvious exits.

(There are no routes out of this room.)

In what year did Spongebob Squarepants premier on television, Wide Open Spaces by the Dixie Chicks won a Grammy, and the Sixth Sense premiered in theaters?

Please enter your answer

>adfsf
That was Round Three, now onto Round Four!

Round4
This is it, the final round. Europe's The Final Countdown is now playing on loop in your head and the questions are worth a whopping twenty points a piece.

You can see no obvious exits.

(There are no routes out of this room.)

Double Think and Cold War are both terms created by what English Author?

Please enter your answer

>G
Incorrect. Next question.

What actor or actress was in X-Men the Last Stand, Inception, and Juno? 

Please enter your answer

>asdf
Incorrect. Next question.

Spteznaz is an umbrella term for special forces from what country?

Please enter your answer

>asdf
Incorrect. Next question.

CVX is the stock ticker symbol for what energy giant?

Please enter your answer

>asf
Incorrect. That was the end of Round Four.

End
Final Score: 0/200

You can go northeast to the Upper Southside Hallway from here.

(From here, you can move to northeast.)

I beg your pardon?

>ne
Upper Southside Hallway
This hallway is NUTS - there are signs everywhere and lights and sounds flashing. From this hallway you can get into a bunch of Party Rooms

You can go north, northeast, northwest to the Veranda Walkway, south, southeast to the Round1, and southwest to the End from here.

(From here, you can move to north, northeast, northwest, south, southeast, and southwest.)

* * *

>se
You can't go that way.

>asd
Incorrect. Next question.

According to the Old Testament, who spent 3 days and nights in the belly of a whale?

Please enter your answer

>asd
Incorrect. Next question.

Kim Jong Il, Joseph Stalin, or Mao Tsedong, which dictator ruled the longest?

Please enter your answer

>d
Incorrect. Next question.

The Tom Green Show and 16 and Pregnant were originally aired on what network?

Please enter your answer

I beg your pardon?

Please enter your answer

>d
That was Round One, now onto Round Two!

Round2
Now onto Round Two where the questions get slightly harder but are worth ten points a piece.

You can see no obvious exits.

(There are no routes out of this room.)

In the contract version of what card game are players identified by points on the compass?

Please enter your answer

>d
That was Round Two, now onto Round Three!

Round3
Round Three is here! The questions are harder but now worth fifteen points a piece.

You can see no obvious exits.

(There are no routes out of this room.)

In 1908, what Ford Model was first produced, eventually being named the Car of the Century?

Please enter your answer

>d
That was Round Three, now onto Round Four!

Round4
This is it, the final round. Europe's The Final Countdown is now playing on loop in your head and the questions are worth a whopping twenty points a piece.

You can see no obvious exits.

(There are no routes out of this room.)

Double Think and Cold War are both terms created by what English Author?

Please enter your answer

>d
Incorrect. Next question.

What actor or actress was in X-Men the Last Stand, Inception, and Juno? 

Please enter your answer

>d
Incorrect. Next question.

CVX is the stock ticker symbol for what energy giant?

Please enter your answer

>d
Incorrect. Next question.

Spteznaz is an umbrella term for special forces from what country?

Please enter your answer

>Russia
Well done. That was the end of Round Four.

End
Final Score: 20/200

You can go northeast to the Upper Southside Hallway from here.

(From here, you can move to northeast.)

Please enter your answer

>dk
Please enter your answer

>df
Please enter your answer

>quit
Please enter your answer

>e
Please enter your answer

* * *

>se
You can't go that way.

>break quiz
Incorrect. Next question.

In which movie did the main character die from super disturbing eye bulging decompression after helmet face plate breakage in the opening scene then but it turned it was just a dream? (or was it a premonition? or was it an implanted memory?)

Please enter your answer

>City of God
Incorrect. Next question.

This movie has a sail boat smash into the end of a fake world. Everyone watching just goes totally nuts.

Please enter your answer

>The Truman Show
Well done.  Next question.

In which film did someone get offered a choice between two pills and then didn't take both of them like they should have?

Please enter your answer

>The Matrix
That was Round One, now onto Round Two!

Round2
Now onto Round Two where the questions get slightly harder but are worth ten points a piece.

You can see no obvious exits.

(There are no routes out of this room.)

What is the capital of Egypt?

Please enter your answer

>Cairo
Well done.  Next question.

What movie has the Highland Games, a Witch, and Craig Ferguson as Lord Macintosh?

Please enter your answer

>Braveheart
That was Round Two, now onto Round Three!

Round3
Round Three is here! The questions are harder but now worth fifteen points a piece.

You can see no obvious exits.

(There are no routes out of this room.)

The Original Ritz Hotel is located in what European City?

Please enter your answer

>London
That was Round Three, now onto Round Four!

Round4
This is it, the final round. Europe's The Final Countdown is now playing on loop in your head and the questions are worth a whopping twenty points a piece.

You can see no obvious exits.

(There are no routes out of this room.)

Who wrote The Coming of the Quantam Cats?

Please enter your answer

>Frederick Pohl
Well done.  Next question.

What is the name of the author who wrote about Sir Luther of Arkwright?

Please enter your answer

>Brian Talbot
Well done.  Next question.

What movie about parallel universes involves a good version of Jet Li trying to stop an evil version of Jet Li?

Please enter your answer

>The One
Well done.  Next question.

Who wrote a series of stories about children travelling between parallel worlds with a powerful knife?

Please enter your answer

>Philip Pullman
Well done. That was the end of Round Four.

End
Final Score: 100/200

You can go northeast to the Upper Southside Hallway from here.

(From here, you can move to northeast.)

I didn't understand that sentence.

>i
You are carrying: 
a quizinator1
a coin
a wig
a dagger
(Health: 100)

[Your score has just gone up by one hundred points.]

>look quizinator
You got this for good quizinating!

* * *

>se
You can't go that way.

>d
Incorrect. Next question.

Kim Jong Il, Joseph Stalin, or Mao Tsedong, which dictator ruled the longest?

Please enter your answer

I beg your pardon?

Please enter your answer

>dd
Incorrect. Next question.

Kim Jong Il, Joseph Stalin, or Mao Tsedong, which dictator ruled the longest?

Please enter your answer

>d
Incorrect. Next question.

According to the Old Testament, who spent 3 days and nights in the belly of a whale?

Please enter your answer

>d
That was Round One, now onto Round Two!

Round2
Now onto Round Two where the questions get slightly harder but are worth ten points a piece.

You can see no obvious exits.

(There are no routes out of this room.)

What is the capital of Egypt?

Please enter your answer

>d
That was Round Two, now onto Round Three!

Round3
Round Three is here! The questions are harder but now worth fifteen points a piece.

You can see no obvious exits.

(There are no routes out of this room.)

The Original Ritz Hotel is located in what European City?

Please enter your answer

>d
That was Round Three, now onto Round Four!

Round4
This is it, the final round. Europe's The Final Countdown is now playing on loop in your head and the questions are worth a whopping twenty points a piece.

You can see no obvious exits.

(There are no routes out of this room.)

Double Think and Cold War are both terms created by what English Author?

Please enter your answer

>d
Incorrect. Next question.

CVX is the stock ticker symbol for what energy giant?

Please enter your answer

* * *

>d
Incorrect. Next question.

Spteznaz is an umbrella term for special forces from what country?

Please enter your answer

>d
Incorrect. Next question.

What actor or actress was in X-Men the Last Stand, Inception, and Juno? 

Please enter your answer

>Ellen Page
Well done. That was the end of Round Four.

End
Final Score: 20/200

You can go northeast to the Upper Southside Hallway from here.

(From here, you can move to northeast.)

I didn't understand that sentence.

* * *

I beg your pardon?

Please enter your answer

>d
Incorrect. Next question.

According to the Old Testament, who spent 3 days and nights in the belly of a whale?

Please enter your answer

>d
Incorrect. Next question.

Kim Jong Il, Joseph Stalin, or Mao Tsedong, which dictator ruled the longest?

Please enter your answer

>d
That was Round One, now onto Round Two!

Round2
Now onto Round Two where the questions get slightly harder but are worth ten points a piece.

You can see no obvious exits.

(There are no routes out of this room.)

In the contract version of what card game are players identified by points on the compass?

Please enter your answer

>d
That was Round Two, now onto Round Three!

Round3
Round Three is here! The questions are harder but now worth fifteen points a piece.

You can see no obvious exits.

(There are no routes out of this room.)

In what year did Spongebob Squarepants premier on television, Wide Open Spaces by the Dixie Chicks won a Grammy, and the Sixth Sense premiered in theaters?

Please enter your answer

>d
That was Round Three, now onto Round Four!

Round4
This is it, the final round. Europe's The Final Countdown is now playing on loop in your head and the questions are worth a whopping twenty points a piece.

You can see no obvious exits.

(There are no routes out of this room.)

What actor or actress was in X-Men the Last Stand, Inception, and Juno? 

Please enter your answer

>d
Incorrect. Next question.

Double Think and Cold War are both terms created by what English Author?

Please enter your answer

>d
Incorrect. Next question.

CVX is the stock ticker symbol for what energy giant?

Please enter your answer

* * *

>d
Incorrect. Next question.

Spteznaz is an umbrella term for special forces from what country?

Please enter your answer

>d
Incorrect. That was the end of Round Four.

End
Final Score: 0/200

You can go northeast to the Upper Southside Hallway from here.

(From here, you can move to northeast.)

* * *

>d
Incorrect. Next question.

Kim Jong Il, Joseph Stalin, or Mao Tsedong, which dictator ruled the longest?

Please enter your answer

>d
Incorrect. Next question.

The Soul and The Optima are both models by what auto make?

Please enter your answer

I beg your pardon?

Please enter your answer

>d
Incorrect. Next question.

Kim Jong Il, Joseph Stalin, or Mao Tsedong, which dictator ruled the longest?

Please enter your answer

>d
That was Round One, now onto Round Two!

Round2
Now onto Round Two where the questions get slightly harder but are worth ten points a piece.

You can see no obvious exits.

(There are no routes out of this room.)

>d
You can't go that way.

>d
You can't go that way.

>d
Incorrect. Next question.

What actor or actress was in X-Men the Last Stand, Inception, and Juno? 

Please enter your answer

* * *

>d
Incorrect. Next question.

CVX is the stock ticker symbol for what energy giant?

Please enter your answer

>d
Incorrect. Next question.

Double Think and Cold War are both terms created by what English Author?

Please enter your answer

>George Orwell
Well done. That was the end of Round Four.

End
Final Score: 20/200

You can go northeast to the Upper Southside Hallway from here.

(From here, you can move to northeast.)

Please enter your answer

* * *

>d
Incorrect. Next question.

The Soul and The Optima are both models by what auto make?

Please enter your answer

>d
Incorrect. Next question.

According to the Old Testament, who spent 3 days and nights in the belly of a whale?

Please enter your answer

I beg your pardon?

Please enter your answer

>d
That was Round One, now onto Round Two!

Round2
Now onto Round Two where the questions get slightly harder but are worth ten points a piece.

You can see no obvious exits.

(There are no routes out of this room.)

What movie has the Highland Games, a Witch, and Craig Ferguson as Lord Macintosh?

Please enter your answer

>d
That was Round Two, now onto Round Three!

Round3
Round Three is here! The questions are harder but now worth fifteen points a piece.

You can see no obvious exits.

(There are no routes out of this room.)

Ebony and Ivory was a duet performed by Stevie Wonder and what former Beatle?

Please enter your answer

>d
That was Round Three, now onto Round Four!

Round4
This is it, the final round. Europe's The Final Countdown is now playing on loop in your head and the questions are worth a whopping twenty points a piece.

You can see no obvious exits.

(There are no routes out of this room.)

CVX is the stock ticker symbol for what energy giant?

Please enter your answer

>d
Incorrect. Next question.

What actor or actress was in X-Men the Last Stand, Inception, and Juno? 

Please enter your answer

>d
Incorrect. Next question.

Spteznaz is an umbrella term for special forces from what country?

Please enter your answer

>Russia
Well done.  Next question.

Double Think and Cold War are both terms created by what English Author?

Please enter your answer

>George Orwell
Well done. That was the end of Round Four.

End
Final Score: 40/200

You can go northeast to the Upper Southside Hallway from here.

(From here, you can move to northeast.)

Please enter your answer

* * *

>d
That was Round One, now onto Round Two!

Round2
Now onto Round Two where the questions get slightly harder but are worth ten points a piece.

You can see no obvious exits.

(There are no routes out of this room.)

What is the capital of Egypt?

Please enter your answer

>d
That was Round Two, now onto Round Three!

Round3
Round Three is here! The questions are harder but now worth fifteen points a piece.

You can see no obvious exits.

(There are no routes out of this room.)

Ebony and Ivory was a duet performed by Stevie Wonder and what former Beatle?

Please enter your answer

>d
That was Round Three, now onto Round Four!

Round4
This is it, the final round. Europe's The Final Countdown is now playing on loop in your head and the questions are worth a whopping twenty points a piece.

You can see no obvious exits.

(There are no routes out of this room.)

What actor or actress was in X-Men the Last Stand, Inception, and Juno? 

Please enter your answer

* * *

>d
Incorrect. Next question.

Double Think and Cold War are both terms created by what English Author?

Please enter your answer

>Chevron
Well done.  Next question.

Spteznaz is an umbrella term for special forces from what country?

Please enter your answer

>Russia
Well done.  Next question.

What actor or actress was in X-Men the Last Stand, Inception, and Juno? 

Please enter your answer

>Ellen Page
Well done. That was the end of Round Four.

End
Final Score: 60/200

You can go northeast to the Upper Southside Hallway from here.

(From here, you can move to northeast.)

Please enter your answer

* * *

>d
Incorrect. Next question.

Double Think and Cold War are both terms created by what English Author?

Please enter your answer

>d
Incorrect. Next question.

Spteznaz is an umbrella term for special forces from what country?

Please enter your answer

>Chevron
Well done.  Next question.

Spteznaz is an umbrella term for special forces from what country?

Please enter your answer

>Russia
Well done. That was the end of Round Four.

End
Final Score: 40/200

You can go northeast to the Upper Southside Hallway from here.

(From here, you can move to northeast.)

Please enter your answer

* * *

>d
Incorrect. Next question.

Spteznaz is an umbrella term for special forces from what country?

Please enter your answer

>d
Incorrect. Next question.

CVX is the stock ticker symbol for what energy giant?

Please enter your answer

>Chevron
Well done. That was the end of Round Four.

End
Final Score: 20/200

You can go northeast to the Upper Southside Hallway from here.

(From here, you can move to northeast.)

I didn't understand that sentence.

>ads
Please enter your answer

* * *

>Chevron
Well done. That was the end of Round Four.

End
Final Score: 20/200

You can go northeast to the Upper Southside Hallway from here.

(From here, you can move to northeast.)

I didn't understand that sentence.

>i
You're carrying a quizinator2 and a coin. You're wearing a wig.

[Your score has just gone up by twenty points.]

>look quizinator2
You got this for bad quizinating.

* * *

>d
Incorrect. Next question.

CVX is the stock ticker symbol for what energy giant?

Please enter your answer

>George Orwell
Well done. That was the end of Round Four.

End
Final Score: 20/200

You can go northeast to the Upper Southside Hallway from here.

(From here, you can move to northeast.)

I didn't understand that sentence.

>i
You're carrying a quizinator1 and a coin. You're wearing a wig.

[Your score has just gone up by twenty points.]

>look quizinator1
You got this for good quizinating!

* * *

>d
Incorrect. Next question.

CVX is the stock ticker symbol for what energy giant?

Please enter your answer

>Russia
Well done. That was the end of Round Four.

End
Final Score: 20/200

You can go northeast to the Upper Southside Hallway from here.

(From here, you can move to northeast.)

Please enter your answer

* * *

>se
You can't go that way.

>e
(first opening the airlock)
As you enter the Veranda Walkway you see a floating dolphin surveillance pod.
Sweet it seems like your ElectroMisdirector shielded you from detection. 

Veranda Walkway
Outside the Space Lounge you look out into the larger Raditree Building to see the pool under a high ceiling. Consuite lies beyond the pool in the main courtyard. Boffers beat each other up in the fenced in section of the courtyard.

You can see an airlock, a black rod, and a floating dolphin (closed) here.

You can go north, northeast, northwest, southeast, west through the airlock to the Space Lounge, up, and down from here.

(From here, you can move to north, northeast, northwest, southeast, west, up, and down.)

>e
Incorrect. Next question.

The Soul and The Optima are both models by what auto make?

Please enter your answer

>e
Incorrect. Next question.

The Tom Green Show and 16 and Pregnant were originally aired on what network?

Please enter your answer

>e
That was Round One, now onto Round Two!

Round2
Now onto Round Two where the questions get slightly harder but are worth ten points a piece.

You can see no obvious exits.

(There are no routes out of this room.)

What movie has the Highland Games, a Witch, and Craig Ferguson as Lord Macintosh?

Please enter your answer

>e
That was Round Two, now onto Round Three!

Round3
Round Three is here! The questions are harder but now worth fifteen points a piece.

You can see no obvious exits.

(There are no routes out of this room.)

In 1908, what Ford Model was first produced, eventually being named the Car of the Century?

Please enter your answer

>e
That was Round Three, now onto Round Four!

Round4
This is it, the final round. Europe's The Final Countdown is now playing on loop in your head and the questions are worth a whopping twenty points a piece.

You can see no obvious exits.

(There are no routes out of this room.)

CVX is the stock ticker symbol for what energy giant?

Please enter your answer

>e
Incorrect. Next question.

What actor or actress was in X-Men the Last Stand, Inception, and Juno? 

Please enter your answer

>e
Incorrect. Next question.

Double Think and Cold War are both terms created by what English Author?

Please enter your answer

>e
Incorrect. Next question.

Spteznaz is an umbrella term for special forces from what country?

Please enter your answer

>Chevron
Well done. That was the end of Round Four.

End
Final Score: 20/200

You can go northeast to the Upper Southside Hallway from here.

(From here, you can move to northeast.)

Please enter your answer

* * *

>e
Incorrect. Next question.

Spteznaz is an umbrella term for special forces from what country?

Please enter your answer

>f
Incorrect. That was the end of Round Four.

End
Final Score: 0/200

You can go northeast to the Upper Southside Hallway from here.

(From here, you can move to northeast.)

* * *

>se
Upper Southside Hallway
This hallway is NUTS - there are signs everywhere and lights and sounds flashing. From this hallway you can get into a bunch of Party Rooms

You can go north, northeast, northwest to the Veranda Walkway, south, southeast, and southwest from here.

(From here, you can move to north, northeast, northwest, south, southeast, and southwest.)

>se
Round1
Welcome to Trivia, I'm your host, a computer program super full of useless information. You will be rewarded with an object based on your score at the end of the quiz.

Wrong answers will not be rewarded with correct answers - I'm not telling you the right answer.

I have ONE singular accepted ABSOLUTELY CORRECT answer it's in a table and it is EXACT and PERFECT - I am the ULTIMATE IMPARTIAL QUIZ JUDGE. If you don't like it...cry me a spriver! OH also you are trapped within my quizzy embrace until the end so just accept your fate. Srsly don't try to leave or anything you'll just waste your answer-chances. The quiz is only four rounds of four questions each - just relax you're not stuck in a Quiz Vortex or anything...(I hope...)

Questions in the first round are worth 5 points a piece, but will increase in value as the game goes on.

Answers must be given with Capitalization and exact spelling.

-----------

The first section is on films involving simulated realities and questionable memories.

Who are you? Are you your memories? Are you what you have done? Are you what you will do? Or are you nothing at all but a wisp...or maybe "just" a program? 

You can go northwest to the Upper Southside Hallway from here.

(From here, you can move to northwest.)

In which film did someone get offered a choice between two pills and then didn't take both of them like they should have?

Please enter your answer

* * *

>se
You can't go that way.

>kia
Incorrect. Next question.

Kim Jong Il, Joseph Stalin, or Mao Tsedong, which dictator ruled the longest?

Please enter your answer

>Mao Tsedong
Well done.  Next question.

The Tom Green Show and 16 and Pregnant were originally aired on what network?

Please enter your answer

>MTV
Well done.  Next question.

According to the Old Testament, who spent 3 days and nights in the belly of a whale?

Please enter your answer

>Jonah
That was Round One, now onto Round Two!

Round2
Now onto Round Two where the questions get slightly harder but are worth ten points a piece.

You can see no obvious exits.

(There are no routes out of this room.)

Get a Mac was an ad slogan for what company from 2006 to 2009? 

Please enter your answer

>Apple
Well done.  Next question.

In the contract version of what card game are players identified by points on the compass?

Please enter your answer

>Bridge
Well done.  Next question.

What is the capital of Egypt?

Please enter your answer

>Cairo
Well done.  Next question.

What movie has the Highland Games, a Witch, and Craig Ferguson as Lord Macintosh?

Please enter your answer

>Brave
That was Round Two, now onto Round Three where things get a bit more difficult!

Round3
Round Three is here! The questions are harder but now worth fifteen points a piece.

You can see no obvious exits.

(There are no routes out of this room.)

Ebony and Ivory was a duet performed by Stevie Wonder and what former Beatle?

Please enter your answer

>Paul McCartney
Well done.  Next question.

In 1908, what Ford Model was first produced, eventually being named the Car of the Century?

Please enter your answer

>Model T
Well done.  Next question.

In what year did Spongebob Squarepants premier on television, Wide Open Spaces by the Dixie Chicks won a Grammy, and the Sixth Sense premiered in theaters?

Please enter your answer

>1999
Well done.  Next question.

The Original Ritz Hotel is located in what European City?

Please enter your answer

>Paris
That was Round Three, now onto Round Four!

Round4
This is it, the final round. Europe's The Final Countdown is now playing on loop in your head and the questions are worth a whopping twenty points a piece.

You can see no obvious exits.

(There are no routes out of this room.)

What actor or actress was in X-Men the Last Stand, Inception, and Juno? 

Please enter your answer

>Ellen Page
Well done.  Next question.

Spteznaz is an umbrella term for special forces from what country?

Please enter your answer

>Russia
Well done.  Next question.

CVX is the stock ticker symbol for what energy giant?

Please enter your answer

* * *

>Chevron
Well done.  Next question.

Double Think and Cold War are both terms created by what English Author?

Please enter your answer

>George Orwell
Well done. That was the end of Round Four.

End
Final Score: 195/200

You can go northeast to the Upper Southside Hallway from here.

(From here, you can move to northeast.)

Please enter your answer

* * *

>se
You can't go that way.

>mao
Incorrect. Next question.

The Soul and The Optima are both models by what auto make?

Please enter your answer

>tesla
Incorrect. Next question.

According to the Old Testament, who spent 3 days and nights in the belly of a whale?

Please enter your answer

>f
Incorrect. Next question.

The Tom Green Show and 16 and Pregnant were originally aired on what network?

Please enter your answer

>a
That was Round One, now onto Round Two!

Round2
Now onto Round Two where the questions get slightly harder but are worth ten points a piece.

You can see no obvious exits.

(There are no routes out of this room.)

What movie has the Highland Games, a Witch, and Craig Ferguson as Lord Macintosh?

Please enter your answer

>asdf
That was Round Two, now onto Round Three!

Round3
Round Three is here! The questions are harder but now worth fifteen points a piece.

You can see no obvious exits.

(There are no routes out of this room.)

Ebony and Ivory was a duet performed by Stevie Wonder and what former Beatle?

Please enter your answer

>adsf
That was Round Three, now onto Round Four!

Round4
This is it, the final round. Europe's The Final Countdown is now playing on loop in your head and the questions are worth a whopping twenty points a piece.

You can see no obvious exits.

(There are no routes out of this room.)

What actor or actress was in X-Men the Last Stand, Inception, and Juno? 

Please enter your answer

>adsf
Incorrect. Next question.

CVX is the stock ticker symbol for what energy giant?

Please enter your answer

>f
Incorrect. Next question.

Double Think and Cold War are both terms created by what English Author?

Please enter your answer

>f
Incorrect. Next question.

Spteznaz is an umbrella term for special forces from what country?

Please enter your answer

>f
Incorrect. That was the end of Round Four.

End
Final Score: 0/200

You can see no obvious exits.

(There are no routes out of this room.)

* * *

>se
You can't go that way.

>s
Incorrect. Next question.

According to the Old Testament, who spent 3 days and nights in the belly of a whale?

Please enter your answer

I beg your pardon?

Please enter your answer

>sdf
Incorrect. Next question.

Kim Jong Il, Joseph Stalin, or Mao Tsedong, which dictator ruled the longest?

Please enter your answer

>df
Incorrect. Next question.

The Soul and The Optima are both models by what auto make?

Please enter your answer

>asdf
That was Round One, now onto Round Two!

Round2
Now onto Round Two where the questions get slightly harder but are worth ten points a piece.

You can see no obvious exits.

(There are no routes out of this room.)

What is the capital of Egypt?

Please enter your answer

>asdf
That was Round Two, now onto Round Three!

Round3
Round Three is here! The questions are harder but now worth fifteen points a piece.

You can see no obvious exits.

(There are no routes out of this room.)

In what year did Spongebob Squarepants premier on television, Wide Open Spaces by the Dixie Chicks won a Grammy, and the Sixth Sense premiered in theaters?

Please enter your answer

>fd
That was Round Three, now onto Round Four!

Round4
This is it, the final round. Europe's The Final Countdown is now playing on loop in your head and the questions are worth a whopping twenty points a piece.

You can see no obvious exits.

(There are no routes out of this room.)

What actor or actress was in X-Men the Last Stand, Inception, and Juno? 

Please enter your answer

>df
Incorrect. Next question.

Spteznaz is an umbrella term for special forces from what country?

Please enter your answer

>df
Incorrect. Next question.

CVX is the stock ticker symbol for what energy giant?

Please enter your answer

>df
Incorrect. Next question.

Double Think and Cold War are both terms created by what English Author?

Please enter your answer

>df
Incorrect. That was the end of Round Four.

End
Final Score: 0/200

You can go northeast to the Upper Southside Hallway from here.

(From here, you can move to northeast.)

>n
You can't go that way.

>ne
Upper Southside Hallway
This hallway is NUTS - there are signs everywhere and lights and sounds flashing. From this hallway you can get into a bunch of Party Rooms

You can go north, northeast, northwest to the Veranda Walkway, south, southeast to the Round1, and southwest to the End from here.

(From here, you can move to north, northeast, northwest, south, southeast, and southwest.)

* * *

>se
You can't go that way.

>truman show
Incorrect. Next question.

This film has annoying gothy villians but a super cool reveal that everyone was in a giant space habitat the WHOLE TIME?! (btw foreshadowing...)

Please enter your answer

>dark city
Incorrect. Next question.

In which film did someone get offered a choice between two pills and then didn't take both of them like they should have?

Please enter your answer

>The Matrix
Well done.  Next question.

In which movie did the main character die from super disturbing eye bulging decompression after helmet face plate breakage in the opening scene then but it turned it was just a dream? (or was it a premonition? or was it an implanted memory?)

Please enter your answer

>Total Recall
That was Round One, now onto Round Two!

Round2
Now onto Round Two where the questions get slightly harder but are worth ten points a piece.

You can see no obvious exits.

(There are no routes out of this room.)

What is the capital of Egypt?

Please enter your answer

>Cairo
Well done.  Next question.

In the contract version of what card game are players identified by points on the compass?

Please enter your answer

>cards
That was Round Two, now onto Round Three!

Round3
Round Three is here! The questions are harder but now worth fifteen points a piece.

You can see no obvious exits.

(There are no routes out of this room.)

Ebony and Ivory was a duet performed by Stevie Wonder and what former Beatle?

Please enter your answer

>Paul Mcartney
That was Round Three, now onto Round Four!

Round4
This is it, the final round. Europe's The Final Countdown is now playing on loop in your head and the questions are worth a whopping twenty points a piece.

You can see no obvious exits.

(There are no routes out of this room.)

Who wrote a series of stories about children travelling between parallel worlds with a powerful knife?

Please enter your answer

>Phillip Pullman
Incorrect. Next question.

What is the name of the author who wrote about Sir Luther of Arkwright?

Please enter your answer

>Jim
Incorrect. Next question.

Who wrote The Coming of the Quantam Cats?

Please enter your answer

>Frederick Pohl
Well done.  Next question.

What movie about parallel universes involves a good version of Jet Li trying to stop an evil version of Jet Li?

Please enter your answer

>The One
Well done. That was the end of Round Four.

End
Final Score: 60/200

You can go northeast to the Upper Southside Hallway from here.

(From here, you can move to northeast.)

I didn't understand that sentence.

>I
You are carrying: 
a quizinator1
a coin
a wig
a dagger
(Health: 100)

[Your score has just gone up by sixty points.]

>use quizinator
I didn't understand that sentence.

>examine quizinator I
I only understood you as far as wanting to examine the quizinator1.

>look quizinator I
I only understood you as far as wanting to look the quizinator1.

>drop quizinator I
I only understood you as far as wanting to drop the quizinator1.

>drop quizinator
Dropped.

>pick up quizinator
You already have that.

>I
You are carrying: 
a quizinator1
a coin
a wig
a dagger
(Health: 100)

>drop quizinator
Dropped.

>i
You are carrying: 
a quizinator1
a coin
a wig
a dagger
(Health: 100)

>look
End
Final Score: 60/200

You can go northeast to the Upper Southside Hallway from here.

(From here, you can move to northeast.)

>look quizinator
You got this for good quizinating!

* * *

>se
You can't go that way.

>sw
End
Final Score: 0/200

You can go northeast to the Upper Southside Hallway from here.

(From here, you can move to northeast.)

* * *

>ne
Upper Southside Hallway
This hallway is NUTS - there are signs everywhere and lights and sounds flashing. From this hallway you can get into a bunch of Party Rooms

You can go north, northeast, northwest to the Veranda Walkway, south, southeast, and southwest to the End from here.

(From here, you can move to north, northeast, northwest, south, southeast, and southwest.)

>se
Round1
Welcome to Trivia, I'm your host, the disembodied voice coming from your device. We have only one rule; please don't cheat. Questions will be simple this round being worth five points a piece, but will increase in both difficulty and value as the game goes on. 

You can go northwest to the Upper Southside Hallway from here.

(From here, you can move to northwest.)

According to the Old Testament, who spent 3 days and nights in the belly of a whale?

Please enter your answer

>d
Incorrect. Next question.

The Tom Green Show and 16 and Pregnant were originally aired on what network?

Please enter your answer

* * *

>d
Incorrect. Next question.

Kim Jong Il, Joseph Stalin, or Mao Tsedong, which dictator ruled the longest?

Please enter your answer

>f
Incorrect. Next question.

The Soul and The Optima are both models by what auto make?

Please enter your answer

>asdf
That was Round One, now onto Round Two!

Round2
Now onto Round Two where the questions get slightly harder but are worth ten points a piece.

You can see no obvious exits.

(There are no routes out of this room.)

What movie has the Highland Games, a Witch, and Craig Ferguson as Lord Macintosh?

Please enter your answer

* * *

>adsf
That was Round Two, now onto Round Three!

Round3
Round Three is here! The questions are harder but now worth fifteen points a piece.

You can see no obvious exits.

(There are no routes out of this room.)

In 1908, what Ford Model was first produced, eventually being named the Car of the Century?

Please enter your answer

>ads
That was Round Three, now onto Round Four!

Round4
This is it, the final round. Europe's The Final Countdown is now playing on loop in your head and the questions are worth a whopping twenty points a piece.

You can see no obvious exits.

(There are no routes out of this room.)

What actor or actress was in X-Men the Last Stand, Inception, and Juno? 

Please enter your answer

>aa
Incorrect. Next question.

Spteznaz is an umbrella term for special forces from what country?

Please enter your answer

>f
Incorrect. Next question.

CVX is the stock ticker symbol for what energy giant?

Please enter your answer

>f
Incorrect. Next question.

Double Think and Cold War are both terms created by what English Author?

Please enter your answer

>s
Incorrect. That was the end of Round Four.

End
Final Score: 0/200

You can go northeast to the Upper Southside Hallway from here.

(From here, you can move to northeast.)

>ne
Upper Southside Hallway
This hallway is NUTS - there are signs everywhere and lights and sounds flashing. From this hallway you can get into a bunch of Party Rooms

You can go north, northeast, northwest to the Veranda Walkway, south, southeast to the Round1, and southwest to the End from here.

(From here, you can move to north, northeast, northwest, south, southeast, and southwest.)

>s
Staging Area
You can see a yellow jersey, a polkadot jersey, a green jersey, a white jersey, and a blue jersey here.

You can go north to the Upper Southside Hallway from here.

(From here, you can move to north.)

>look yellow
Since 1919, the Tour de France has awarded this jersey to the race leader.

>look pokadot
You can't see any such thing.

>look polkadot
Since 1933, the Tour de France has awarded this jersey to the King of the Mountains.

>look green
Since 1953, the Tour de France has awarded this jersey to the highest point scorer on sprints.

>look white
Since 1975, the Tour de France has awarded this jersey to the best cyclist aged 25 or less.

>look blue
blue jersaaaay

* * *

>e
Oh, e eh!? I've heard a you.

Space Lounge
You are in the Space Lounge. It's dim and glowy all over with pulsating colors and subtle hypnotic sounds.

You can see an airlock, a black ninja outfit, a bar (on which are a Glowing Sphere and a glittery box (closed)), a bench, a comfy looking chair, a bartender, AFrame, and a securityBot here.

You can go east through the airlock (closed) and west from here.

>sw
You can't go that way.

>se
Upper Southside Hallway
This hallway is NUTS - there are signs everywhere and lights and sounds flashing. From this hallway you can get into a bunch of Party Rooms

You can go north, northeast, northwest to the Veranda Walkway, and south from here.

(From here, you can move to north, northeast, northwest, and south.)

>s
Staging Area
You can see a yellow jersey, a polkadot jersey, a green jersey, a white jersey, and a blue jersey here.

You can go north to the Upper Southside Hallway from here.

(From here, you can move to north.)

* * *

>e
Oh, e eh!? I've heard a you.

Space Lounge
You are in the Space Lounge. It's dim and glowy all over with pulsating colors and subtle hypnotic sounds.

You can see an airlock, a black ninja outfit, a bar (on which are a Glowing Sphere and a glittery box (closed)), a bench, a comfy looking chair, a bartender, AFrame, and a securityBot here.

You can go east through the airlock (closed) and west from here.

>take ninja
Taken.

* * *

>wear ninja
You are a ninja! It feels like you could blend into the shadows, or maybe you ARE the shadows, this ninja outfit makes you feel super ninja-like

>e
(first opening the airlock)
As you enter the Veranda Walkway you see a floating dolphin surveillance pod.
Sweet it seems like your AdBlaster2000 shielded you from detection. 

Veranda Walkway
Outside the Space Lounge you look out into the larger Raditree Building to see the pool under a high ceiling. Consuite lies beyond the pool in the main courtyard. Boffers beat each other up in the fenced in section of the courtyard.

You can see an airlock, a black rod, and a floating dolphin (closed) here.

You can go north, northeast, northwest, southeast, west through the airlock to the Space Lounge, up, and down from here.

(From here, you can move to north, northeast, northwest, southeast, west, up, and down.)

>i
You're carrying a message receiver, a coin, and a dagger. You're wearing a black ninja outfit and AdBlaster2000.

* * *

>e
Oh, e eh!? I've heard a you.

Space Lounge
You are in the Space Lounge. It's dim and glowy all over with pulsating colors and subtle hypnotic sounds.

You can see an airlock, a black ninja outfit, a bar (on which are a Glowing Sphere and a glittery box (closed)), a bench, a comfy looking chair, a bartender, AFrame, and a securityBot here.

You can go east through the airlock (closed) and west from here.

>w
Space Lounge
You are in the Space Lounge, rumored to be the center of The Resistance. "Why did I come here?" you briefly wonder before looking around.

You can see an airlock, a bar (on which are a glittery box (closed) and a Glowing Sphere), a chair, a bench, and a bartender here.

(From here, you can move to east.)

>open box
You open the glittery box, revealing a security readout, a bowl, and a crazy looking gun.

>take readout
Taken.

>take bown
You can't see any such thing.

>look bowl
The bowl is kind of unremarkable, not really exciting like some cool crazy gun would be or something.

In the bowl is a note.

>look note
Cast the secret spell xyzzy

>xyzzy
You are unable to articulate the second "z" separately from the first, and the spell fails in a disdainful puff. If only you had the black rod.

>take note
Taken.

>take gun
You have no idea what this gun does. You've never seen anything like it! You're pretty stoked to get this gun.

Taken.

>look sphere
OOOOoooo glowy-sphere thingie! Its purple soft glow makes you feel safe and secure. It looks like there's some sort of helix-key as a component to the glowy-ness but it's unclear how you would remove it.

* * *

>take key
That seems to be a part of the Glowing Sphere.

>shoot sphere with gun
ZAP! The Glowing Sphere twinkles out of existence! The security key clatters to the ground!

>take key
Taken.

>look readout
The screen is blank.

The security readout is currently switched off.

>turn on readout
You switch the security readout on.

>look readout
The screen reads: 

 airlock (Space Lounge/Veranda Walkway): UNLOCKED

>lock airlock
(first closing the airlock)
(with the security key)
You lock the airlock.

>w
You can't go that way.

>e
(first opening the airlock)
(first unlocking the airlock)
(with the security key)

Veranda Walkway
Outside the Space Lounge you look out into the larger Raditree Building to see the pool with under a high ceiling. Consuite lies beyond the pool in the main courtyard. Boffers beat each other up in the fenced in section of the courtyard. A floating dolphin surveillance pod floats by making you twitch instintively to make your shiny wig come between the camera and your face.

You can see an airlock, a black rod, and a floating dolphin (closed) here.

(From here, you can move to north, northeast, northwest, southeast, west, up, and down.)

>w
Space Lounge
You are in the Space Lounge, rumored to be the center of The Resistance. "Why did I come here?" you briefly wonder before looking around.

You can see an airlock, a bar (on which is a glittery box (in which is a bowl (empty))), a chair, a bench, and a bartender here.

(From here, you can move to east.)

>e
Veranda Walkway
Outside the Space Lounge you look out into the larger Raditree Building to see the pool with under a high ceiling. Consuite lies beyond the pool in the main courtyard. Boffers beat each other up in the fenced in section of the courtyard. A floating dolphin surveillance pod floats by making you twitch instintively to make your shiny wig come between the camera and your face.

You can see an airlock, a black rod, and a floating dolphin (closed) here.

(From here, you can move to north, northeast, northwest, southeast, west, up, and down.)

>open dolphin
(first unlocking the floating dolphin)
You lack a key that fits the floating dolphin.

>u
You don't have wings or pyscho-kinetic levitation abilities or a hoverboard or anything to go up with.

>d
Under the Veranda Walkway
Under the Veranda Walkway

(From here, you can move to north, northeast, southeast, east, west, and up.)

* * *

>enter chair
Oh boy this chair looks really soft and comfy! Ooooh ya you are totally gonna sit on this chair big time.

You sit down and are so comfortable - you could really get used to being in this chair. Really! Wowsers...it's just the comfiest thing you probably ever plopped yer can on...it's like you're almost part of this thing...like your skin is melding with it and your insides are turning to some sort of tiny little beans...or a kind of foam batting material...

"What a lovely soft and dreamy world", you think. Nothing is wrong and everything is right. Right and soft. Sooooo sooooofffft.

>exit chair
I only understood you as far as wanting to exit.

>leave chair
I only understood you as far as wanting to leave.

>get off chiar
You can't see any such thing.

>get off chair
You just can't get up, you are way too comfortable! Maybe if you just stayed here in this chair forever you would be better off than whatever else you were going to do. Does it really matter?

"What a lovely soft and dreamy world", you think. Nothing is wrong and everything is right. Right and soft. Sooooo sooooofffft.

* * *

>get off chair
You try to heave yourself up, but the soft lusciousness of the chair envelopes you and pulls you back into its comfy folds. Oooooo...so comfy...so sooooooofffffft...

"What a lovely soft and dreamy world", you think. Nothing is wrong and everything is right. Right and soft. Sooooo sooooofffft.

>get of chair
You can't see any such thing.

>get off chair
Whew! You just barely escaped that chair, it's so comfy you could get stuck in it forever!

>enter chair
Oh boy this chair looks really soft and comfy! Ooooh ya you are totally gonna sit on this chair big time.

"Hey Wait!" your subconscious jumps forth remembering the tempting softness - you decide not not to sit on that chair, it's so comfy you might never get up again! It looks seriously comfy though...maybe just for a little tiny sliver of a moment you could get kinda comfy...

>get off chair
But you aren't on the chair at the moment.

* * *

>fuck you
fuck you!? Har har har! Musta been one-a them vat babies huh?

Space Lounge
You are in the Space Lounge. It's dim and glowy all over with pulsating colors and subtle hypnotic sounds.

You can see an airlock, a black ninja outfit, a bar (on which are a Glowing Sphere and a glittery box (closed)), a bench, a softChair, a bartender, AFrame, and a securityBot here.

>look chair
The soft chair looks seriously comfortable, it's all soft and squishy looking. "SPYUMMY", your butt thinks.

>sit on chair
Oh boy this chair looks really soft and comfy! Ooooh ya you are totally gonna sit on this chair big time.

You get onto the chair.

"What a lovely soft and dreamy world", you think. Nothing is wrong and everything is right. Right and soft. Sooooo sooooofffft.

>look
Space Lounge (on the chair)
You are in the Space Lounge. It's dim and glowy all over with pulsating colors and subtle hypnotic sounds.

You can see an airlock, a black ninja outfit, a bar (on which are a Glowing Sphere and a glittery box (closed)), a bench, a bartender, AFrame, and a securityBot here.

You can go east through the airlock (closed) and west from here.

"What a lovely soft and dreamy world", you think. Nothing is wrong and everything is right. Right and soft. Sooooo sooooofffft.

>take outfit
You'd rather be asleep. Whatever other thing you would do besides being in this chair is a bad idea and not really that good of an option compared to being in this insanely comfy chair.

"What a lovely soft and dreamy world", you think. Nothing is wrong and everything is right. Right and soft. Sooooo sooooofffft.

* * *

>fuck you
fuck you!? Har har har! Musta been one-a them vat babies huh?

Space Lounge
You are in the Space Lounge. It's dim and glowy all over with pulsating colors and subtle hypnotic sounds.

You can see an airlock, a black ninja outfit, a bar (on which are a Glowing Sphere and a glittery box (closed)), a bench, a softChair, a bartender, AFrame, and a securityBot here.

>sit on chair
You can't see any such thing.

>sit on softChair
Oh boy this chair looks really soft and comfy! Ooooh ya you are totally gonna sit on this chair big time.

You get onto the softChair.

on a soft thing

>get up from softChair
You just can't get up, you are way too comfortable! Maybe if you just stayed here in this softChair forever you would be better off than whatever else you were going to do. Does it really matter?

on a soft thing

>get up from softChair
You try to heave yourself up, but the soft lusciousness of the softChair envelopes you and pulls you back into its comfy folds. Oooooo...so comfy...so sooooooofffffft...

on a soft thing

>get up from softChair
Whew! You just barely escaped that softChair, it's so comfy you could get stuck in it forever!

>get up
But you aren't in anything at the moment.

>sit on chair
You can't see any such thing.

>sit on softChair
Oh boy this chair looks really soft and comfy! Ooooh ya you are totally gonna sit on this chair big time.

"Hey Wait!" your subconscious jumps forth remembering the tempting softness - you decide not not to sit on that softChair, it's so comfy you might never get up again! It looks seriously comfy though...maybe just for a little tiny sliver of a moment you could get kinda comfy...

>sit on softChair
Oh boy this chair looks really soft and comfy! Ooooh ya you are totally gonna sit on this chair big time.

Don't you remember the last time you were in that softChair? It almost ATE YOU! What is your deal? Don't sit in this softChair, it's too dangerous! Only a master of mental projection could sit on this softChair without its super soft comfy-ness obliterating and subsuming your soul to its dark comfy desires.

>sit on softChair
Oh boy this chair looks really soft and comfy! Ooooh ya you are totally gonna sit on this chair big time.

    *** You sit on the chair again and sink forever into its comfyness. You never rise again. ***

In that game you scored 0 out of a possible 0, in 8 turns.

Would you like to RESTART, RESTORE a saved game, QUIT, or UNDO the last command?

* * *

>give bartender coin
She accepts with a smile and slides you a smoothie. It looks friggin delicious.

>i
You're carrying a smoothie. You're wearing a wig.

>look at smoothie
This thing is like taking a bath in frozen unicorn snot. Amazing.

* * *

>give bartender coin
She accepts with a smile and slides you a smoothie. It looks friggin delicious.

>inventory
You're carrying a smoothie. You're wearing a wig.

* * *

>give bartender coin
She accepts with a smile and slides you a smoothie. It looks friggin delicious.

>look at smoothie
You can't see any such thing.

>look at blah
This thing is like taking a bath in frozen unicorn snot. Amazing.

* * *

>give coin to bartender
give coin to bartender!? Har har har! Musta been one-a them vat babies huh?

Space Lounge
You are in the Space Lounge. It's dim and glowy all over with pulsating colors and subtle hypnotic sounds.

You can see an airlock, a black ninja outfit, a bar (on which are a Glowing Sphere and a glittery box (closed)), a bench, a chair, a bartender, AFrame, and a Security bot here.

You can go east through the airlock (closed) and west from here.

(From here, you can move to east and west.)

>give coin to bartender
She accepts with a smile and slides you a smoothie. It looks friggin delicious.

* * *

>go east
(first opening the airlock)

Veranda Walkway
Outside the Space Lounge you look out into the larger Raditree Building to see the pool with under a high ceiling. Consuite lies beyond the pool in the main courtyard. Boffers beat each other up in the fenced in section of the courtyard. A floating dolphin surveillance pod floats by making you twitch instintively to make your shiny wig come between the camera and your face.

You can see an airlock, a black rod, and a floating dolphin (closed) here.

(From here, you can move to north, northeast, northwest, southeast, west, up, and down.)

>n
Floor Changer
Elevators, escalators, and stairwell.

(From here, you can move to north, northeast, south, east, west, and down.)

>n
Elevator
You are in an elevator!

(From here, you can move to south.)

>s
Floor Changer
Elevators, escalators, and stairwell.

(From here, you can move to north, northeast, south, east, west, and down.)

>d
Lower Floor Changer
Lower elevators, escalators and stairwell lower level

(From here, you can move to north, northeast, south, and up.)

>n
Elevator
You are in an elevator!

(From here, you can move to south.)

* * *

>go north
You can't go that way.

>go south
(first opening the airlock)
It seems to be locked.

>open box
You open the glittery box, revealing a security readout, a bowl and a crazy looking gun.

>take gun
You have no idea what this gun does. You've never seen anything like it! You're pretty stoked to get this gun.

Taken.

* * *

>take key
Taken.

>open airlock
It seems to be locked.

>open airlock with key
You unlock the airlock.

>go airlock
(first opening the airlock)

Overlooking Hallway
Outside the Space Lounge you look out into the larger Raditree Building to see the pool with under a high ceiling. Consuite lies beyond the pool in the main courtyard. Boffers beat each other up in the fenced in section of the courtyard. A floating dolphin surveillance pod floats by making you twitch instintively to make your shiny wig come between the camera and your face.

You can see an airlock, a black rod and a floating dolphin (empty) here.

>take rod
Taken.

>xyzzy
you feel a whooshy sound enter your eyeball sockets and then your tummy flips over your groiny-place. WHOOOOOAAAA suddenly you find yourself trasported to the...

Secret Room
You are in the Secret Room. DON'T TELL ANYONE YOU WERE EVER HERE! It's really dark, you can't see much.

Under the influence of the black rod, you pronounce this as Xhi-zee.

>cast xyzzy
you feel a whooshy sound enter your eyeball sockets and then your tummy flips over your groiny-place. WHOOOOOAAAA suddenly you find yourself trasported to the...

Secret Room
You are in the Secret Room. DON'T TELL ANYONE YOU WERE EVER HERE! It's really dark, you can't see much.

Under the influence of the black rod, you pronounce this as Xhi-zee.

* * *

>hg
hg!? Har har har! Musta been one-a them vat babies huh?

Space Lounge
You are in the Space Lounge. It's dim and glowy all over with pulsating colors and subtle hypnotic sounds.

You can see an airlock, a black ninja outfit, a bar (on which are a Glowing Sphere and a glittery box (closed)), a bench, a chair, a bartender, AFrame, and a Security bot here.

You can go east through the airlock (closed) and west from here.

(From here, you can move to east and west.)

>i
You are carrying: 
DiscoWig
a message receiver
a coin
a dagger
(Health: 100)

>l discowig
This wig is all sproingy and is made of tons of tiny pieces of holographic metallic rainbow shards. As you move about the light around you is refracted into a million directions, making face recog almost impossible.

>look ninja
This is a ninja outfit, it's black and has a hood that covers your face. It has pockets in it to store cool ninja gear. It has these sweet built in booties that muffle your footsteps as if you were a total ninja, which you totally are if you are wearing this outfit. You could sneak around a place with shadows without being detected if you were wearing this thing. You'd be so ninja.

The pocket contains nothing.

>take ninja
Taken.

* * *

>wear ninja
You are a ninja! It feels like you could blend into the shadows, or maybe you ARE the shadows, this ninja outfit makes you feel super ninja-like

>look self
You are in perfect health. (Health: 100)

>look
Space Lounge
You are in the Space Lounge. It's dim and glowy all over with pulsating colors and subtle hypnotic sounds.

You can see an airlock, a bar (on which are a Glowing Sphere and a glittery box (closed)), a bench, a chair, a bartender, AFrame, and a Security bot here.

You can go east through the airlock (closed) and west from here.

(From here, you can move to east and west.)

>look bench
Cool smooth bench.

>look chair
The soft chair looks seriously comfortable, it's all soft and squishy looking. "SPYUMMY", your butt thinks.

>look bartender
The bartender is standing there looking you over.

(Health: 100)

>look AFrame
Aframe is looking pretty sharp there wearing a pin-striped suit with his usual aplomb.

(Health: 100)

>look Security bot
Looks like a standard security bot.

(Health: 100)

>look
Space Lounge
You are in the Space Lounge. It's dim and glowy all over with pulsating colors and subtle hypnotic sounds.

You can see an airlock, a bar (on which are a Glowing Sphere and a glittery box (closed)), a bench, a chair, a bartender, AFrame, and a Security bot here.

You can go east through the airlock (closed) and west from here.

(From here, you can move to east and west.)

>open airlock
You open the airlock.

>look
Space Lounge
You are in the Space Lounge. It's dim and glowy all over with pulsating colors and subtle hypnotic sounds.

You can see an airlock, a bar (on which are a Glowing Sphere and a glittery box (closed)), a bench, a chair, a bartender, AFrame, and a Security bot here.

You can go east through the airlock and west from here.

(From here, you can move to east and west.)

>look sphere
OOOOoooo glowy-sphere thingie! Its purple soft glow makes you feel safe and secure. It looks like there's some sort of helix-key as a component to the glowy-ness but it's unclear how you would remove it.

>look glittery box
Time slows down, you feel as if you gazing into the cosmos itself. Your eyeballs can hardly stay on it, it's like your gaze just keeps sliding off.

>open box
You open the glittery box, revealing a security readout, a bowl, and a crazy looking gun.

>look readout
The screen is blank.

The security readout is currently switched off.

>look message receiver
Dear hg, 

You really should meet me tonight in the Space Lounge...you're gonna be pumped! -AFrame

* * *

>i
You're carrying a coin. You're wearing a wig.

>e
(first opening the airlock)

Veranda Walkway
Outside the Space Lounge you look out into the larger Raditree Building to see the pool with under a high ceiling. Consuite lies beyond the pool in the main courtyard. Boffers beat each other up in the fenced in section of the courtyard. A floating dolphin surveillance pod floats by making you twitch instintively to make your shiny wig come between the camera and your face.

You can see an airlock, a black rod, and a floating dolphin (closed) here.

You can go north, northeast, northwest, southeast, west through the airlock to the Space Lounge, up, and down from here.

(From here, you can move to north, northeast, northwest, southeast, west, up, and down.)

>n
Floor Changer
Elevators, escalators, and stairwell.

You can go northeast, northwest, south to the Veranda Walkway, east, west, and down from here.

(From here, you can move to northeast, northwest, south, east, west, and down.)

* * *

>wear ninja
You put on the ninja costume.

>i
You're empty-handed. You're wearing a ninja costume and a wig.

* * *

>i
You're carrying a coin. You're wearing a wig.

>give bartender coin
She accepts with a smile.

>ask bartender about xx
"Sorry, I don't know much about that," The bartender comments throatily.

>xx
That's not a verb I recognize.

>bartender xx
That's not a verb I recognize.

>xx bartender
That's not a verb I recognize.

* * *

>inventory
You're carrying a coin. You're wearing a wig.

>give bartender coin
She accepts with a smile.

* * *

>jk
jk? Interesting, nice.

Space Lounge
You are in the Space Lounge. It's dim and glowy all over with pulsating colors and subtle hypnotic sounds.

You can see an airlock, a black ninja outfit, a bar (on which are a Glowing Sphere and a glittery box (closed)), a bench, a comfy looking chair, a bartender, AFrame, and a securityBot here.

>sit on chair
Oh boy this chair looks really soft and comfy! Ooooh ya you are totally gonna sit on this chair big time.

You get onto the comfy looking chair.

"What was I trying to do?" you think for a sec before you realize how comfy the chair you are in is. It's kind of incredible, you feel like you've accomlished enough in life.

>get up
You'd rather be asleep. Whatever other thing you would do besides being in this chair is a bad idea and not really that good of an option compared to being in this insanely comfy chair.

Sooooo comfy. So sooooo comfy. Mmmmm...

* * *

>get up
You'd rather be asleep. Whatever other thing you would do besides being in this chair is a bad idea and not really that good of an option compared to being in this insanely comfy chair.

"What was I trying to do?" you think for a sec before you realize how comfy the chair you are in is. It's kind of incredible, you feel like you've accomlished enough in life.

I beg your pardon?

I beg your pardon?

>get up
You'd rather be asleep. Whatever other thing you would do besides being in this chair is a bad idea and not really that good of an option compared to being in this insanely comfy chair.

Sooooo comfy. So sooooo comfy. Mmmmm...

>get up from chair
You just can't get up, you are way too comfortable! Maybe if you just stayed here in this comfy looking chair forever you would be better off than whatever else you were going to do. Does it really matter?

Oooh yes, this is a wonderful world. What a luxuriously decadent and beautiful reality to be in" you think as you nestle further within the folds of the chair

>get off chair
You try to heave yourself up, but the soft lusciousness of the comfy looking chair envelopes you and pulls you back into its comfy folds. Oooooo...so comfy...so sooooooofffffft...

"What was I trying to do?" you think for a sec before you realize how comfy the chair you are in is. It's kind of incredible, you feel like you've accomlished enough in life.

>get off chair
Whew! You just barely escaped that comfy looking chair, it's so comfy you could get stuck in it forever!

* * *

>kadsf
kadsf? Interesting, nice.

Space Lounge
You are in the Space Lounge. It's dim and glowy all over with pulsating colors and subtle hypnotic sounds.

You can see an airlock, a black ninja outfit, a bar (on which are a Glowing Sphere and a glittery box (closed)), a bench, a chair, a bartender, AFrame, and a Security bot here.

>look box
Time slows down, you feel as if you are gazing into the cosmos itself. Your eyeballs can hardly stay on it, it's like your gaze just keeps sliding off.

>open box
You open the glittery box, revealing a security readout, a bowl, and a crazy looking gun.

>take box
OOOHhhhhhh! You get a funny tingle when you try to pick the box up, the sides are so slippery it almost feels COMPLETELY FRICTIONLESS. You can't seem to grab it all, it's really weird.

>look box
Time slows down, you feel as if you are gazing into the cosmos itself. Your eyeballs can hardly stay on it, it's like your gaze just keeps sliding off.

In the glittery box are a security readout, a bowl, and a crazy looking gun.

>look security
(the Security bot)
Looks like a standard security bot.

>look security readout
The screen is blank.

The security readout is currently switched off.

* * *

>lasdf
lasdf!? Har har har! Musta been one-a them vat babies huh?

Space Lounge
You are in the Space Lounge. It's dim and glowy all over with pulsating colors and subtle hypnotic sounds.

You can see an airlock, a black ninja outfit, a bar (on which are a Glowing Sphere and a glittery box (closed)), a bench, a chair, a bartender, AFrame, and a Security bot here.

>look sphere
OOOOoooo glowy-sphere thingie! Its purple soft glow makes you feel safe and secure. It looks like there's some sort of helix-key as a component to the glowy-ness encased inside the glow.

* * *

>look
h, look eh!? I've heard a you.

Space Lounge
You are in the Space Lounge. It's dim and glowy all over with pulsating colors and subtle hypnotic sounds.

You can see an airlock, a black ninja outfit, a bar (on which are a Glowing Sphere and a glittery box (closed)), a bench, a comfy looking chair, a bartender, AFrame, and a securityBot here.

>ask aframe about xx
When you mention xx, Aframe's eyes light up. He smiles and looks around the room for a second before stepping closer to you. "How do you know aobut xx?", he says - well it doesn't matter now - just remember yy when you get to the zz okay? DON'T FORGET ABOUT THE YY! Then he looks around again and slowly fades from view, like all the color faded to grey, then all the outlines of his features just slowly alpha-fade to zero.

>look self
As good-looking as ever.

>i
You're carrying a coin. You're wearing a wig.

>give coin to aframe
You can't see any such thing.

>give coin to bartender
She accepts with a smile.

>look bartender
The bartender is standing there looking you over.

>look bartender
The bartender is dancing.

>look
Space Lounge
You are in the Space Lounge, rumored to be the center of The Resistance. "Why did I come here?" you briefly wonder before looking around.

You can see an airlock, a bar (on which are a glittery box (closed) and a Glowing Sphere), a chair, a bench, a bartender, a black ninja outfit, and a Security bot here.

You can go east through the airlock (closed) from here.

(From here, you can move to east.)

>look
Space Lounge
You are in the Space Lounge, rumored to be the center of The Resistance. "Why did I come here?" you briefly wonder before looking around.

You can see an airlock, a bar (on which are a glittery box (closed) and a Glowing Sphere), a chair, a bench, a bartender, a black ninja outfit, and a Security bot here.

You can go east through the airlock (closed) from here.

(From here, you can move to east.)

>look bartender
The bartender is standing there looking you over.

* * *

>look bartender
The bartender is dancing.

>look bartender
The bartender is standing there looking you over.

>look bartender
The bartender is making a glow in the dark smoothie.

>look bartender
The bartender is dancing.

* * *

>look bartender
The bartender is standing there looking you over.

>look bartender
The bartender is serving some smoothies.

>look bartender
The bartender is cleaning the blender.

>look bartender
The bartender is dancing.

>look bartender
The bartender is serving some smoothies.

* * *

>look bartender
The bartender is cleaning the blender.

>look bartender
The bartender is talking with a friend.

>look bartender
The bartender is cleaning the blender.

>look bartender
The bartender is making a neon yellow smoothie.

>i
You're empty-handed. You're wearing a wig.

* * *

>look
h, look eh!? I've heard a you.

Space Lounge
You are in the Space Lounge. It's dim and glowy all over with pulsating colors and subtle hypnotic sounds.

You can see an airlock, a black ninja outfit, a bar (on which are a Glowing Sphere and a glittery box (closed)), a bench, a comfy looking chair, a bartender, AFrame, and a securityBot here.

>e
(first opening the airlock)

Veranda Walkway
Outside the Space Lounge you look out into the larger Raditree Building to see the pool with under a high ceiling. Consuite lies beyond the pool in the main courtyard. Boffers beat each other up in the fenced in section of the courtyard. A floating dolphin surveillance pod floats by making you twitch instintively to make your shiny wig come between the camera and your face.

You can see an airlock, a black rod, and a floating dolphin (closed) here.

You can go north, northeast, northwest, southeast, west through the airlock to the Space Lounge, up, and down from here.

(From here, you can move to north, northeast, northwest, southeast, west, up, and down.)

* * *

>w
Convergence Central
Convergence Central

You can go northeast, south, southwest, and east to the Floor Changer from here.

(From here, you can move to northeast, south, southwest, and east.)

>map
That's not a verb I recognize.

>look
Convergence Central
Convergence Central

You can go northeast, south, southwest, and east to the Floor Changer from here.

(From here, you can move to northeast, south, southwest, and east.)

>sw
Dealer's Room
Dealer's Room

You can see a ninja costume here.

You can go northeast to Convergence Central from here.

(From here, you can move to northeast.)

* * *

>take ninja costume
Taken.

>look self
As good-looking as ever.

>hit points
You can't see any such thing.

* * *

>look
h, look eh!? I've heard a you.

Space Lounge
You are in the Space Lounge. It's dim and glowy all over with pulsating colors and subtle hypnotic sounds.

You can see an airlock, a black ninja outfit, a bar (on which are a Glowing Sphere and a glittery box (closed)), a bench, a comfy looking chair, a bartender, AFrame, and a securityBot here.

>look Mario Hat
You can't see any such thing.

>look
Space Lounge
You are in the Space Lounge, rumored to be the center of The Resistance. "Why did I come here?" you briefly wonder before looking around.

You can see an airlock, a bar (on which are a glittery box (closed) and a Glowing Sphere), a chair, a bench, and a bartender here.

You can go east through the airlock (closed) from here.

(From here, you can move to east.)

>e
(first opening the airlock)

Veranda Walkway
Outside the Space Lounge you look out into the larger Raditree Building to see the pool with under a high ceiling. Consuite lies beyond the pool in the main courtyard. Boffers beat each other up in the fenced in section of the courtyard. A floating dolphin surveillance pod floats by making you twitch instintively to make your shiny wig come between the camera and your face.

You can see an airlock, a black rod, and a floating dolphin (closed) here.

You can go north, northeast, northwest, southeast, west through the airlock to the Space Lounge, up, and down from here.

(From here, you can move to north, northeast, northwest, southeast, west, up, and down.)

* * *

>look
h, look eh!? I've heard a you.

Space Lounge
You are in the Space Lounge. It's dim and glowy all over with pulsating colors and subtle hypnotic sounds.

You can see an airlock, a black ninja outfit, a bar (on which are a Glowing Sphere and a glittery box (closed)), a bench, a comfy looking chair, a bartender, AFrame, and a securityBot here.

>open box
You open the glittery box, revealing a securityReadout, a bowl, and a crazy looking gun.

>look securityReadout
The screen is blank.

The securityReadout is currently switched off.

* * *

>look
h, look eh!? I've heard a you.

Space Lounge
You are in the Space Lounge. It's dim and glowy all over with pulsating colors and subtle hypnotic sounds.

You can see an airlock, a black ninja outfit, a bar (on which are a Glowing Sphere and a glittery box (closed)), a bench, a comfy looking chair, a bartender, AFrame, and a securityBot here.

>sit chair
I didn't understand that sentence.

>sit on chair
Oh boy this chair looks really soft and comfy! Ooooh ya you are totally gonna sit on this chair big time.

You sit down and are so comfortable - you could really get used to being in this chair. Really! Wowsers...it's just the comfiest thing you probably ever plopped yer can on...it's like you're almost part of this thing...like your skin is melding with it and your insides are turning to some sort of tiny little beans...or a kind of foam batting material...

"What a lovely soft and dreamy world", you think. Nothing is wrong and everything is right. Right and soft. Sooooo sooooofffft.

>look
Space Lounge (on the chair)
You are in the Space Lounge, rumored to be the center of The Resistance. "Why did I come here?" you briefly wonder before looking around.

You can see an airlock, a bar (on which are a glittery box (closed) and a Glowing Sphere), a bench, a bartender, a black ninja outfit, AFrame, and a Security bot here.

You can go east through the airlock (closed) from here.

(From here, you can move to east.)

"What a lovely soft and dreamy world", you think. Nothing is wrong and everything is right. Right and soft. Sooooo sooooofffft.

>e
(first opening the airlock)
(first unlocking the airlock)
You'd rather be asleep. Whatever other thing you would do besides being in this chair is a bad idea and not really that good of an option compared to being in this insanely comfy chair.

"What a lovely soft and dreamy world", you think. Nothing is wrong and everything is right. Right and soft. Sooooo sooooofffft.

>get up from chair
You just can't get up, you are way too comfortable! Maybe if you just stayed here in this chair forever you would be better off than whatever else you were going to do. Does it really matter?

"What a lovely soft and dreamy world", you think. Nothing is wrong and everything is right. Right and soft. Sooooo sooooofffft.

>get up from chair
You try to heave yourself up, but the soft lusciousness of the chair envelopes you and pulls you back into its comfy folds. Oooooo...so comfy...so sooooooofffffft...

"What a lovely soft and dreamy world", you think. Nothing is wrong and everything is right. Right and soft. Sooooo sooooofffft.

>get up from chair
"What a lovely soft and dreamy world", you think. Nothing is wrong and everything is right. Right and soft. Sooooo sooooofffft.

>get up from chair
Whew! You just barely escaped that chair, it's so comfy you could get stuck in it forever!

>get up from chair
But you aren't on the chair at the moment.

>look chair
Watch out for that chair, it's so comfy you could get stuck in it forever! Like LITERALLY foreverandever.

>sit on chair
Oh boy this chair looks really soft and comfy! Ooooh ya you are totally gonna sit on this chair big time.

"Hey Wait!" your subconscious jumps forth remembering the tempting softness - you decide not not to sit on that chair, it's so comfy you might never get up again! It looks seriously comfy though...maybe just for a little tiny sliver of a moment you could get kinda comfy...

* * *

>look AFrame
You can't see any such thing.

>take costume
Taken.

>look costume
The black ninja costume is kind of unremarkable, not really exciting like some cool crazy gun would be or something.

The black ninja costume's pocket contains a throwing star and a smoke bomb.

>wear costume
You put on the black ninja costume.

>look self
As good-looking as ever.

* * *

>look aframe
Aframe is looking pretty sharp there wearing a pin-striped suit with his usual aplomb.

>aframe, remove suit
He says "sure, anything for a laugh!"
AFrame takes off the pin-striped suit.

>look aframe
Aframe is looking pretty sharp there wearing a pink thong with his usual aplomb.

>aframe, remove pink thong
He says "sure, anything for a laugh!"
AFrame takes off the pink thong.

>look aframe
Aframe is looking pretty sharp there wearing nothing with his usual aplomb.

>aframe, put on pink thong
He says "sure, anything for a laugh!"
AFrame puts on the pink thong.

>aframe, put on suit
He says "sure, anything for a laugh!"
AFrame puts on the pin-striped suit.

>take ninja outfit
Taken.

>give aframe ninja outfit
AFrame doesn't seem interested.

>aframe, take ninja outfit
He says "sure, anything for a laugh!"
AFrame is unable to do that.

>e
(first opening the airlock)
(first unlocking the airlock)
You lack a key that fits the airlock.

>look
Space Lounge
You are in the Space Lounge, rumored to be the center of The Resistance. "Why did I come here?" you briefly wonder before looking around.

You can see an airlock, a bar (on which are a glittery box (closed) and a Glowing Sphere), a chair, a bench, a bartender, AFrame, and a Security bot here.

You can go east through the airlock (closed) from here.

(From here, you can move to east.)

>tell aframe
I didn't understand that sentence.

>tell aframe to put on ninja suit
I didn't understand that sentence.

>i
You're carrying a black ninja outfit and a coin. You're wearing a wig.

>open box
You open the glittery box, revealing a security readout, a bowl, and a crazy looking gun.

* * *

>shoot aframe
(with the crazy looking gun)
This weird ray comes out of your gun but it's like it's moving in slow-motion...as the beam wiggles toward Aframe super duper slow he steps out of the way of it. The wiggling intensifies and disappears. Aframe is looking at you with this annoyed look. Like he doesn't totally trust you anymore because you just tried to twinkle him out of existence.

>aframe, remove suit
He says "uhm I am not going to help you out because in case you forgot you tried to kill me. I don't even know why"

* * *

>take gun
You have no idea what this gun does. You've never seen anything like it! You're pretty stoked to get this gun.

Taken.

>shoot aframe with gun
This weird ray comes out of your gun but it's like it's moving in slow-motion...as the beam wiggles toward Aframe super duper slow and he steps out of the way of it, the wiggling intensifies and disappears. Aframe is looking at you with this annoyed look. Like he doesn't totally trust you anymore because you just tried to twinkle him out of existence.

>aframe, remove suit
He says "uhm I am not going to help you out because in case you forgot you tried to kill me. I don't even know why

* * *

>look aframe
Aframe is looking pretty sharp there wearing a pin-striped suit with his usual aplomb.

>ask aframe to take off his suit
I didn't understand that sentence.

>ask aframe to remove suit
I didn't understand that sentence.

>aframe, remove suit
AFrame takes off the pin-striped suit.

>look aframe
Aframe leans on a polystyrene pillar, wearing a pink thong with his usual aplomb.

>ask aframe about xx
When you mention xx, Aframe's eyes light up. He smiles and looks around the room for a second before stepping closer to you. "How do you know aobut xx?", he says - well it doesn't matter now - just remember yy when you get to the zz okay? DON'T FORGET ABOUT THE YY! Then he looks around again and slowly fades from view, like all the color faded to grey, then all the outlines of his features just slowly alpha-faded to zero.

>look
Space Lounge
You are in the Space Lounge, rumored to be the center of The Resistance. "Why did I come here?" you briefly wonder before looking around.

You can see an airlock, a bar (on which are a glittery box (closed) and a Glowing Sphere), a chair, a bench, a bartender, a black ninja outfit, and a Security bot here.

You can go east through the airlock (closed) from here.

(From here, you can move to east.)

>look aframe
You can't see any such thing.

* * *

>take rod
Taken.

>xyyz
That's not a verb I recognize.

>w
Space Lounge
You are in the Space Lounge, rumored to be the center of The Resistance. "Why did I come here?" you briefly wonder before looking around.

You can see an airlock, a bar (on which are a glittery box (closed) and a Glowing Sphere), a chair, a bench, a bartender, a black ninja outfit, and a Security bot here.

You can go east through the airlock to the Veranda Walkway from here.

(From here, you can move to east.)

>look box
Time slows down, you feel as if you gazing into the cosmos itself. Your eyeballs can hardly stay on it, it's like your gaze just keeps sliding off.

>open box
You open the glittery box, revealing a security readout, a bowl, and a crazy looking gun.

>look bowl
The bowl is kind of unremarkable, not really exciting like some cool crazy gun would be or something.

In the bowl is a note.

* * *

>look note
Cast the secret spell xyzzy

>xyzzy
you feel a whooshy sound enter your eyeball sockets and then your tummy flips over your groiny-place. WHOOOOOAAAA suddenly you find yourself trasported to the...

you feel a whooshy sound enter your eyeball sockets and then your tummy flips over your groiny-place. WHOOOOOAAAA suddenly you find yourself trasported to the...

Secret Room
You are in the Secret Room. DON'T TELL ANYONE YOU WERE EVER HERE! It's really dark, you can't see much.

You can see AFrame, a dolphin code, and a book here.

You can see no obvious exits.

(There are no routes out of this room.)

Under the influence of the black rod, you pronounced "xyzzy" as Xhi-zee. You understand now that the purpose of the black rod is to bring people here, to the Secret Room.

>talk aframe
That's not a verb I recognize.

* * *

>look airlock
The airlock has a small window through which you can see a vast open space - is that a pool? Sweet!. There's some sort of security readout thing on the door and it looks like the door only opens with a security key.

>look readout
You can't see any such thing.

>look at readout
You can't see any such thing.

>look airlock readout
I only understood you as far as wanting to look the airlock.

>e
(first opening the airlock)

Veranda Walkway
Outside the Space Lounge you look out into the larger Raditree Building to see the pool with under a high ceiling. Consuite lies beyond the pool in the main courtyard. Boffers beat each other up in the fenced in section of the courtyard. A floating dolphin surveillance pod floats by making you twitch instintively to make your shiny wig come between the camera and your face.

You can see an airlock, a black rod, and a floating dolphin (closed) here.

You can go north, northeast, northwest, southeast, west through the airlock to the Space Lounge, up, and down from here.

(From here, you can move to north, northeast, northwest, southeast, west, up, and down.)

>look ceiling
The ceiling with lights rises over the whole crazy convention.

* * *

>look bartender
The bartender is serving some smoothies.

>look bartender
The bartender is dancing.

* * *

>look bartender
The bartender is standing there looking you over.

>look bartender
The bartender is cleaning the blender.

* * *

>look bartender
The bartender is talking with a friend.

>look bartender
The bartender is making a glow in the dark smoothie.

* * *

>look bartender
The bartender is dancing.

>look bartender
The bartender is cleaning the blender.

* * *

>look bartender
The bartender is standing there looking you over.

>look bartender
The bartender is making a neon yellow smoothie.

>look bartender
The bartender is dancing.

>talk bartender
That's not a verb I recognize.

>talk with bartender
That's not a verb I recognize.

>bartender, hello
There is no reply.

>ask bartender for smoothie
You can't see any such thing.

* * *

>look boffer
Standard boffer looking bloke, wearing simple leather armor and wielding a staff and smiling at you menacingly.

(Health: 100)

>attack boffer
Violence isn't the answer to this one.

>i
You are carrying: 
a coin
a wig
a dagger
(Health: 100)

>stab boffer with dagger
You stab the boffer with your the dagger. The boffer yells out in pain.  (The boffer's health: 96)

>look boffer
Standard boffer looking bloke, wearing simple leather armor and wielding a staff and smiling at you menacingly.

(Health: 96)

>stab boffer with dagger
You stab the boffer with your the dagger. The boffer yells out in pain.  (The boffer's health: 89)

* * *

>look boffer
Standard boffer looking bloke, wearing simple leather armor and wielding a staff and smiling at you menacingly.

(Health: 100)

>look boffer staff
I only understood you as far as wanting to look the boffer.

>ask boffer to fight
I didn't understand that sentence.

>attack boffer
Violence isn't the answer to this one.

* * *

>look box
Time slows down, you feel as if you gazing into the cosmos itself. Your eyeballs can hardly stay on it, it's like your gaze just keeps sliding off.

>open box
You open the glittery box, revealing a bowl and a crazy looking gun.

>look bowl
The bowl is kind of unremarkable, not really exciting like some cool crazy gun would be or something.

In the bowl is a note.

>look gun
That gun is so crazy looking! It's kind of like totally blowing your mind.

>look note
Cast the secret spell xyzzy

>cast spell
I didn't understand that sentence.

>xyzzy
You are unable to articulate the second "z" separately from the first, and the spell fails in a disdainful puff. If only you had the black rod.

>get rod
Taken.

>xyzzy
you feel a whooshy sound enter your eyeball sockets and then your tummy flips over your groiny-place. WHOOOOOAAAA suddenly you find yourself trasported to...

Overlooking Hallway
Outside the Space Lounge you look out into the larger Raditree Building to see the pool with under a high ceiling. Consuite lies beyond the pool in the main courtyard. Boffers beat each other up in the fenced in section of the courtyard. A floating dolphin surveillance pod floats by making you twitch instintively to make your shiny wig come between the camera and your face.

You can see a floating dolphin (empty) here.

Under the influence of the black rod, you pronounce this as Xhi-zee.

>look
Overlooking Hallway
Outside the Space Lounge you look out into the larger Raditree Building to see the pool with under a high ceiling. Consuite lies beyond the pool in the main courtyard. Boffers beat each other up in the fenced in section of the courtyard. A floating dolphin surveillance pod floats by making you twitch instintively to make your shiny wig come between the camera and your face.

You can see a floating dolphin (empty) here.

>look dolphin
Oh crap - the floating dolphin's survellance cam is honing in on you! You better get out of here, somewhere where the floating dolphin camera can't see you.

>go north
You can't go that way.

>go east
You can't go that way.

>got west
That's not a verb I recognise.

>go west
You can't go that way.

>get dolphin
That's fixed in place.

>go south
Space Lounge
You are in the Space Lounge, rumored to be the center of The Resistance. "Why did I come here?" you briefly wonder before looking around. You can go north to exit the Space Lounge.

You can see a bar (on which is a glittery box (in which are a bowl (in which is a note) and a crazy looking gun)), a soft chair, a skate ramp technology chair, Many soft chairs and a bartender here.

>look chair
Which do you mean, the soft chair or the skate ramp technology chair?

>look skate ramp technology chair
The skate ramp technology chair is kind of unremarkable, not really exciting like some cool crazy gun would be or something.

>look soft chair
The soft chair is kind of unremarkable, not really exciting like some cool crazy gun would be or something.

>sit chair
I didn't understand that sentence.

>get gun
You have no idea what this gun does. You've never seen anything like it! You're pretty stoked to get this gun.

Taken.

>go north
Overlooking Hallway
Outside the Space Lounge you look out into the larger Raditree Building to see the pool with under a high ceiling. Consuite lies beyond the pool in the main courtyard. Boffers beat each other up in the fenced in section of the courtyard. A floating dolphin surveillance pod floats by making you twitch instintively to make your shiny wig come between the camera and your face.

You can see a floating dolphin (empty) here.

>shoot gun
(at the black rod)
ZAP! The black rod twinkles out of existence!

>go south
Space Lounge
You are in the Space Lounge, rumored to be the center of The Resistance. "Why did I come here?" you briefly wonder before looking around. You can go north to exit the Space Lounge.

You can see a bar (on which is a glittery box (in which is a bowl (in which is a note))), a soft chair, a skate ramp technology chair, Many soft chairs and a bartender here.

>talk bartender
That's not a verb I recognise.

>speak bartender
(to the bartender)
There is no reply.

>go north
Overlooking Hallway
Outside the Space Lounge you look out into the larger Raditree Building to see the pool with under a high ceiling. Consuite lies beyond the pool in the main courtyard. Boffers beat each other up in the fenced in section of the courtyard. A floating dolphin surveillance pod floats by making you twitch instintively to make your shiny wig come between the camera and your face.

You can see a floating dolphin (empty) here.

>look dolphin
Oh crap - the floating dolphin's survellance cam is honing in on you! You better get out of here, somewhere where the floating dolphin camera can't see you.

>enter dolphin
You get into the floating dolphin.

>go south
Space Lounge (in the floating dolphin)
You are in the Space Lounge, rumored to be the center of The Resistance. "Why did I come here?" you briefly wonder before looking around. You can go north to exit the Space Lounge.

You can see a bar (on which is a glittery box (in which is a bowl (in which is a note))), a soft chair, a skate ramp technology chair, Many soft chairs and a bartender here.

>shoot bartender
(with the crazy looking gun)
ZAP! The bartender twinkles out of existence!

>shoot dolphin
(with the crazy looking gun)
ZAP! The floating dolphin twinkles out of existence! 

*** Run-time problem P61: Attempt to move the player off-stage.

>look
Space Lounge (in the floating dolphin)
You are in the Space Lounge, rumored to be the center of The Resistance. "Why did I come here?" you briefly wonder before looking around. You can go north to exit the Space Lounge.

You can see a bar (on which is a glittery box (in which is a bowl (in which is a note))), a soft chair, a skate ramp technology chair and Many soft chairs here.

>shoot me
(with the crazy looking gun)
That would be disastrous!

>shoot gun
What do you want to shoot the crazy looking gun at?

>shoot space lounge
You can't see any such thing.

>shoot gun with gun
Nice trick if you can do it!

* * *

>look box
Time slows down, you feel as if you gazing into the cosmos itself. Your eyeballs can hardly stay on it, it's like your gaze just keeps sliding off.

>take box
OOOHhhhhhh! You get a funny tingle when you try to pick the box up, the sides are so slippery it almost feels COMPLETELY FRICTIONLESS. You can't seem to grab it all, it's really weird.

>look sphere
OOOOoooo glowy-sphere thingie! Its purple soft glow makes you feel safe and secure. It looks like there's some sort of helix-key as a component to the glowy-ness but it's unclear how you would remove it.

>take sphere
That's fixed in place.

>break sphere
Violence isn't the answer to this one.

>go east
(first opening the airlock)

Veranda Walkway
Outside the Space Lounge you look out into the larger Raditree Building to see the pool with under a high ceiling. Consuite lies beyond the pool in the main courtyard. Boffers beat each other up in the fenced in section of the courtyard. A floating dolphin surveillance pod floats by making you twitch instintively to make your shiny wig come between the camera and your face.

You can see an airlock, a black rod, and a floating dolphin (closed) here.

(From here, you can move to north, northeast, northwest, southeast, west, up, and down.)

>go north
Floor Changer
Elevators, escalators, and stairwell.

(From here, you can move to northeast, northwest, south, east, west, and down.)

>go north west
I only understood you as far as wanting to go north.

>go northwest
Upper Tower Connector
The Upper Tower Connector - connection between the short and tall towers.

(From here, you can move to southeast and southwest.)

>go southwest
Convergence Central
Convergence Central

(From here, you can move to northeast, south, southwest, and east.)

>go south
Mainstage
Mainstage

(From here, you can move to north.)

>go north
Convergence Central
Convergence Central

(From here, you can move to northeast, south, southwest, and east.)

>go east
Floor Changer
Elevators, escalators, and stairwell.

(From here, you can move to northeast, northwest, south, east, west, and down.)

>go w
Convergence Central
Convergence Central

(From here, you can move to northeast, south, southwest, and east.)

>go sw
Dealer's Room
Dealer's Room

(From here, you can move to northeast.)

>ne
Convergence Central
Convergence Central

(From here, you can move to northeast, south, southwest, and east.)

>e
Floor Changer
Elevators, escalators, and stairwell.

(From here, you can move to northeast, northwest, south, east, west, and down.)

>down
Lower Floor Changer
Lower elevators, escalators and stairwell lower level

(From here, you can move to north, northeast, northwest, south, southwest, west, and up.)

>n
Elevator Line
You are waiting for an elevator!

(From here, you can move to south.)

>s
Lower Floor Changer
Lower elevators, escalators and stairwell lower level

(From here, you can move to north, northeast, northwest, south, southwest, west, and up.)

>ne
Stairwell Floor 1
Stairwell Floor 1

(From here, you can move to southwest and up.)

>sw
Lower Floor Changer
Lower elevators, escalators and stairwell lower level

(From here, you can move to north, northeast, northwest, south, southwest, west, and up.)

>w
Front Desk
The Front Desk

(From here, you can move to east.)

>e
Lower Floor Changer
Lower elevators, escalators and stairwell lower level

(From here, you can move to north, northeast, northwest, south, southwest, west, and up.)

>up
Floor Changer
Elevators, escalators, and stairwell.

(From here, you can move to northeast, northwest, south, east, west, and down.)

>up
You can't go that way.

>e
Upper Northside Hallway
A hallway filled with freaks and nerds.

(From here, you can move to south, southeast, southwest, and west.)

>s
Room 205
Room 205

(From here, you can move to north.)

>n
Upper Northside Hallway
A hallway filled with freaks and nerds.

(From here, you can move to south, southeast, southwest, and west.)

>se
Consuite
(From here, you can move to northwest, southwest, and down.)

>nw
Upper Northside Hallway
A hallway filled with freaks and nerds.

(From here, you can move to south, southeast, southwest, and west.)

>se
Consuite
(From here, you can move to northwest, southwest, and down.)

* * *

>look chair
The soft chair looks seriously comfortable, it's all soft and squishy looking. "SPYUMMY", your butt thinks.

>sit chair
I didn't understand that sentence.

>sit on chair
Oh boy this chair looks really soft and comfy! Ooooh ya you are totally gonna sit on this chair big time.

You sit down and are so comfortable - you could really get used to being in this chair.

"What a lovely soft and dreamy world", you think. Nothing is wrong and everything is right. Right and soft. Sooooo sooooofffft.

>get up
You'd rather be asleep.

"What a lovely soft and dreamy world", you think. Nothing is wrong and everything is right. Right and soft. Sooooo sooooofffft.

>get up
You'd rather be asleep.

"What a lovely soft and dreamy world", you think. Nothing is wrong and everything is right. Right and soft. Sooooo sooooofffft.

>get out of chair
I only understood you as far as wanting to get outside.

>get up
You'd rather be asleep.

"What a lovely soft and dreamy world", you think. Nothing is wrong and everything is right. Right and soft. Sooooo sooooofffft.

>wake up
You'd rather be asleep.

"What a lovely soft and dreamy world", you think. Nothing is wrong and everything is right. Right and soft. Sooooo sooooofffft.

>get out of chair
I only understood you as far as wanting to get outside.

>stand
You'd rather be asleep.

"What a lovely soft and dreamy world", you think. Nothing is wrong and everything is right. Right and soft. Sooooo sooooofffft.

>get up from chair
You just can't get up, you are way too comfortable!

"What a lovely soft and dreamy world", you think. Nothing is wrong and everything is right. Right and soft. Sooooo sooooofffft.

>get up from chair
You try to heave yourself up, but the soft lusciousness of the chair envelopes you and pulls you back into its comfy folds.

"What a lovely soft and dreamy world", you think. Nothing is wrong and everything is right. Right and soft. Sooooo sooooofffft.

>get up from chair
"What a lovely soft and dreamy world", you think. Nothing is wrong and everything is right. Right and soft. Sooooo sooooofffft.

* * *

>get up from chair
Whew! You just barely escaped that chair, it's so comfy you could get stuck in it forever!

>sit bench
I didn't understand that sentence.

* * *

>sit on bench
You get onto the bench.

>look
Space Lounge (on the bench)
You are in the Space Lounge, rumored to be the center of The Resistance. "Why did I come here?" you briefly wonder before looking around.

You can see an airlock, a bar (on which are a glittery box (closed) and a Glowing Sphere), a chair, and a bartender here.

You can go east through the airlock (closed) from here.

(From here, you can move to east.)

>open glittery box
You open the glittery box, revealing a security readout, a bowl, and a crazy looking gun.

>look bartender
You see a female bartender with neon hair and glowing robes serving drinks. The bartender is currently helping some other people but if you wait you can probably get a chance to talk to her.

* * *

>look ninja
This is a ninja outfit, it's black and has a hood that covers your face. It has pockets on it to store cool ninja gear. It has these sweet built in booties that muffle your footsteps as if you were a total ninja, which you totally are if you are wearing this outfit. You could totally sneak into a place without being detected if it was dark and you were wearing this thing. You'd be so ninja.

The pocket contains nothing.

>look self
As good-looking as ever.

>take ninja
Taken.

* * *

>wear ninja
You are a ninja! It feels like you could blend into the shadows, or maybe you ARE the shadows, this ninja outfit makes you feel super ninja-like

>i
You're empty-handed. You're wearing a black ninja outfit and a wig.

>look
Space Lounge
You are in the Space Lounge, rumored to be the center of The Resistance. "Why did I come here?" you briefly wonder before looking around.

You can see an airlock, a bar (on which are a glittery box (closed) and a Glowing Sphere), a chair, a bench, and a bartender here.

You can go east through the airlock (closed) from here.

(From here, you can move to east.)

>look bartender
You see a female bartender with neon hair and glowing robes serving drinks. The bartender is currently helping some other people but if you wait you can probably get a chance to talk to her.

* * *

>look self
You are in perfect health. (Health: 100)

>inventory
You are carrying: 
a coin
a wig
a dagger
(Health: 100)

>i
You are carrying: 
a coin
a wig
a dagger
(Health: 100)

>look dagger
The dagger is kind of unremarkable, not really exciting like some cool crazy gun would be or something.

>look wig
This wig is super shiny and silvery, reflecting light off in all directions, it helps you avoid being face-detected by the intero-pods.

>look coin
The coin is kind of unremarkable, not really exciting like some cool crazy gun would be or something.

>look
Space Lounge
You are in the Space Lounge. "Why did I come here?" you briefly wonder before looking around.

You can see an airlock, a black ninja outfit, a bar (on which are a Glowing Sphere and a glittery box (closed)), a bench, a chair, a bartender, AFrame, and a Security bot here.

You can go east through the airlock (closed) from here.

(From here, you can move to east.)

>talk AFrame
I didn't understand that sentence.

>Aframe, hello
You say hello to AFrame.

* * *

>matt
matt? Interesting, nice.

Space Lounge
You are in the Space Lounge. It's dim and glowy all over with pulsating colors and subtle hypnotic sounds.

You can see an airlock, a black ninja outfit, a bar (on which are a Glowing Sphere and a glittery box (closed)), a bench, a chair, a bartender, AFrame, and a Security bot here.

>east
(first opening the airlock)
As you enter the Veranda Walkway you see a floating dolphin surveillance pod.
Sweet it seems like your DiscoWig shielded you from detection. 

Veranda Walkway
Outside the Space Lounge you look out into the larger Raditree Building to see the pool under a high ceiling. Consuite lies beyond the pool in the main courtyard. Boffers beat each other up in the fenced in section of the courtyard.

You can see an airlock, a black rod, and a floating dolphin (closed) here.

>se
Upper Southside Hallway
This hallway is NUTS - there are signs everywhere and lights and sounds flashing. From this hallway you can get into a bunch of Party Rooms

>se
Round1
Welcome to Trivia, I'm your host, a computer program super full of useless information. You will be rewarded with an object based on your score at the end of the quiz.

Wrong answers will not be rewarded with correct answers - I'm not telling you the right answer.

I have ONE singular accepted ABSOLUTELY CORRECT answer it's in a table and it is EXACT and PERFECT - I am the ULTIMATE IMPARTIAL QUIZ JUDGE. If you don't like it...cry me a spriver! OH also you are trapped within my quizzy embrace until the end so just accept your fate. Srsly don't try to leave or anything you'll just waste your answer-chances. The quiz is only four rounds of four questions each - just relax you're not stuck in a Quiz Vortex or anything...(I hope...)

Questions in the first round are worth 5 points a piece, but will increase in value as the game goes on.

Answers must be given with Capitalization and exact spelling.

-----------

The first section is on films involving simulated realities and questionable memories.

Who are you? Are you your memories? Are you what you have done? Are you what you will do? Or are you nothing at all but a wisp...or maybe "just" a program? 

This film has annoying gothy villians but a super cool reveal that everyone was in a giant space habitat the WHOLE TIME?! (btw foreshadowing...)

Please enter your answer

>dark city
Incorrect. Next question.

In which film did someone get offered a choice between two pills and then didn't take both of them like they should have?

Please enter your answer

>The Matrix
Well done.  Next question.

This movie has a sail boat smash into the end of a fake world. Everyone watching just goes totally nuts.

Please enter your answer

>sdfg
Incorrect. Next question.

In which movie did the main character die from super disturbing eye bulging decompression after helmet face plate breakage in the opening scene then but it turned it was just a dream? (or was it a premonition? or was it an implanted memory?)

Please enter your answer

>Total Recall
That was Round One, now onto Round Two!

Round2
Now onto Round Two where the questions are worth ten points a piece. The subject of this round is Interactive Fiction! M(meta)E(meta)T(meta)A

Colossal Cave Adventure featured a "magic word" that caused teleportation and has shown up again and again in video games ever since.  It enables cheat modes, opens Easter Eggs and has inspired many silly programs. Type this magic word in lowercase now.

Please enter your answer

>xyzzy
Well done.  Next question.

In what game series are you likely to be eaten by a grue if you travel into dark places without a light source?

Please enter your answer

* * *

>Zork
Well done.  Next question.

This Apple II game features a game play element where the player is given a three-digit code at the beginning of play and is instructed to never reveal this code to anyone. At one point the game appears to crash as a way of tricking the player into revealing their code, in which case they lose the game. What is the name of this game?

Please enter your answer

>The Prisoner
Well done.  Next question.

Around 1975, a programmer and amateur caver wrote the first text adventure game whose name originally was all caps and only six characters long because of filename length limitations of that time. What is the name of this game (the all-caps six letter version)

Please enter your answer

>ADVENT
That was Round Two, now onto Round Three where things get a bit more difficult!

Round3
Round Three is here! The questions are harder but now worth fifteen points a piece. These ones are about going INSIDE THE COMPUTER!

This 80"s movie about Virtual Reality was such garbage that it basically halted research and tech development in VR for about 20 years.

Please enter your answer

>Lawnmower Man
Incorrect. Next question.

What is the name of the anime about a VRMMORPG where the players have to play until they either die or someone beats the game? No logging out. WHAAaaaa? Wicked eh?

Please enter your answer

>Sword Art Online
Well done.  Next question.

This character started out as a real-life-human-reporter but after someone tried to kill him he ended up in a coma and then got his mind uploaded TO A COMPUTER. The transition altered his personality forever.

Please enter your answer

>SJDF
Incorrect. Next question.

Who is the actor who played the program Crom in Tron - you might also know him as Londo...

Please enter your answer

>sdf
That was Round Three, now onto Round Four!

Round4
This is it, the final round. You're so close to escaping this quiz that not even a Quiz Vortex could keep you from exiting the quiz-field. The questions are worth twenty points a piece.

This round is about choices, random forces and what they lead to...which is of course PARALLEL UNIVERSES!

Every imagined-not-taken choice spawned from every individual's mind throughout time and space creating entire universes with every passing thought. The vast sea of thought embracing the infinite seeds of thought; the birth of what-ifs reflecting infinitely. 

Who wrote The Coming of the Quantam Cats, which includes a parallel universe prison planet, and a triad -relationship including three different versions of the same person? (OMG that is so hawt!)

Please enter your answer

>Frederik Pohl
Well done.  Next question.

Who wrote a series of stories about children travelling between parallel worlds with a powerful knife, and has book titles inspired by Paradise Lost?

Please enter your answer

>Philip Pullman
Well done.  Next question.

What is the name of the author who wrote about Sir Luther of Arkwright - a hero who can travel through the parallels at will?

Please enter your answer

>Billy
Incorrect. Next question.

What movie about parallel universes involves a good version of Jet Li trying to stop an evil version of Jet Li who is determined to gain ultimate power by being the only version of himself throughout all universes?

Please enter your answer

>The One
Well done. That was the end of Round Four.

End
Final Score: 125/200

I didn't understand that sentence.

>i
You're carrying a quizinator1, a message receiver, a coin, and a dagger. You're wearing DiscoWig.

[Your score has just gone up by one hundred twenty-five points.]

>drop quiz
You can't see any such thing.

>look quizinator
You got this for good quizinating!

>look coin
The coin is kind of unremarkable, not really exciting like some cool crazy gun would be or something.

>l
End
Final Score: 125/200

>xyzzy
You are unable to articulate the second "z" separately from the first, and the spell fails in a disdainful puff. If only you had some sort of magical item to focus your arcane arts upon to increase your attunement to the fey realm.

>plugh
I didn't understand that sentence.

* * *

>move east
You must name something more substantial.

>move to east
You can't see any such thing.

>east
(first opening the airlock)
(first unlocking the airlock)
You lack a key that fits the airlock.

>open airlock
(first unlocking the airlock)
You lack a key that fits the airlock.

>unlock airlock
You lack a key that fits the airlock.

>glittery box
That's not a verb I recognize.

>open glittery box
You open the glittery box, revealing a security readout, a bowl, and a crazy looking gun.

>take gun
You have no idea what this gun does. You've never seen anything like it! You're pretty stoked to get this gun.

Taken.

>take bowl
Taken.

>take security readout
Taken.

>shoot airlock
(with the crazy looking gun)
The crazy gun's ray just bounces off the airlock, it doesn't seem to be able to affect it.

>shoot bartender
(with the crazy looking gun)
The weird ray somehow seems to bend around the bartender and disperses into a cloud of neon-swirled rainbow shards. She looks at you with a strange smirky side-eye. She must be wearing some kind of personal ray-deflector device. "splick", you admire-think.

>shoot bench
(with the crazy looking gun)
ZAP! The bench twinkles out of existence!

>shoot chair
(with the crazy looking gun)
ZAP! The chair twinkles out of existence!

>shoot glowing sphere
(with the crazy looking gun)
ZAP! The Glowing Sphere twinkles out of existence! The security key clatters to the ground!

>take security key
Taken.

>take black ninja outfit
Taken.

>shoot bar
(with the crazy looking gun)
ZAP! The bar twinkles out of existence!

>shoot aframe
(with the crazy looking gun)
This weird ray comes out of your gun but it's like it's moving in slow-motion...as the beam wiggles toward Aframe super duper slow he steps out of the way of it. The wiggling intensifies and disappears. Aframe is looking at you with this annoyed look. Like he doesn't totally trust you anymore because you just tried to twinkle him out of existence.

>shoot security
Which do you mean, the Security bot, the security key, or the security readout?

>shoot security boy
Which do you mean, the Security bot, the security key, or the security readout?

>shoot security bot
(with the crazy looking gun)
ZAP! The Security bot twinkles out of existence!

>unlock airlock
(with the security key)
You unlock the airlock.

>east
(first opening the airlock)

Veranda Walkway
Outside the Space Lounge you look out into the larger Raditree Building to see the pool with under a high ceiling. Consuite lies beyond the pool in the main courtyard. Boffers beat each other up in the fenced in section of the courtyard. A floating dolphin surveillance pod floats by making you twitch instintively to make your shiny wig come between the camera and your face.

You can see an airlock, a black rod, and a floating dolphin (closed) here.

You can go north, northeast, northwest, southeast, west through the airlock to the Space Lounge, up, and down from here.

(From here, you can move to north, northeast, northwest, southeast, west, up, and down.)

>take black rod
Taken.

>take floating dolphin
That's fixed in place.

>open floating dolphin
(first unlocking the floating dolphin)
You lack a key that fits the floating dolphin.

>west
Space Lounge
You are in the Space Lounge, rumored to be the center of The Resistance. "Why did I come here?" you briefly wonder before looking around.

You can see an airlock, a bartender, and AFrame here.

You can go east through the airlock to the Veranda Walkway from here.

(From here, you can move to east.)

>look aframe
Aframe is looking pretty sharp there wearing a pin-striped suit with his usual aplomb.

>ask aframe
What do you want to ask AFrame for?

>ask aframe suit
I didn't understand that sentence.

>ask aframe, suit
You can't use multiple objects with that verb.

>ask aframe what is your suit
I didn't understand that sentence.

>aframe, remove suit
He says "uhm I am not going to help you out because in case you forgot you tried to kill me. I don't even know why"

>unshoot aframe
That's not a verb I recognize.

>apologize aframe
That's not a verb I recognize.

>give black ninja suit to aframe
You can only do that to something animate.

>give aframe security key
AFrame doesn't seem interested.

>give aframe black rod
AFrame doesn't seem interested.

>ask aframe xx
I didn't understand that sentence.

>ask aframe about xx
When you mention xx, Aframe's eyes light up. He smiles and looks around the room for a second before stepping closer to you. "How do you know aobut xx?", he says - well it doesn't matter now - just remember yy when you get to the zz okay? DON'T FORGET ABOUT THE YY! Then he looks around again and slowly fades from view, like all the color faded to grey, then all the outlines of his features just slowly alpha-fade to zero.

>say cool
(to the bartender)
"Hm, you've got me there," The bartender comments.

>say beer
(to the bartender)
"Sorry, I don't know much about that," The bartender drawls huskily.

>ask bartender for a beer
You can't see any such thing.

>say whisky
(to the bartender)
"I'm afraid you've got me there," The bartender comments silkily.

>say noodles
(to the bartender)
"Hm, I don't know much about that," The bartender replies.

>say xx
(to the bartender)
"I'm afraid you've got me there," The bartender comments huskily.

>say yy
(to the bartender)
"Hm, I haven't the faintest," The bartender replies throatily.

>say zz
(to the bartender)
"Sorry, you've got me there," The bartender comments throatily.

>ask zz
You can't see any such thing.

>ask aframe
You can't see any such thing.

>east
Veranda Walkway
Outside the Space Lounge you look out into the larger Raditree Building to see the pool with under a high ceiling. Consuite lies beyond the pool in the main courtyard. Boffers beat each other up in the fenced in section of the courtyard. A floating dolphin surveillance pod floats by making you twitch instintively to make your shiny wig come between the camera and your face.

You can see an airlock and a floating dolphin (closed) here.

You can go north, northeast, northwest, southeast, west through the airlock to the Space Lounge, up, and down from here.

(From here, you can move to north, northeast, northwest, southeast, west, up, and down.)

>use black rod dolphin
That's not a verb I recognize.

>read security
Which do you mean, the security key or the security readout?

>read security readout
The screen is blank.

The security readout is currently switched off.

>turn on security readout
You switch the security readout on.

>read security readout
The screen reads: 

 airlock (Space Lounge/Veranda Walkway): UNLOCKED

>read note
Cast the secret spell xyzzy

* * *

>say woah
(to AFrame)
There is no reply.

>say how did i get here
(to AFrame)
There is no reply.

>say suit
(to AFrame)
There is no reply.

>say xx
(to AFrame)
When you mention xx, Aframe's eyes light up. He smiles and looks around the room for a second before stepping closer to you. "How do you know aobut xx?", he says - well it doesn't matter now - just remember yy when you get to the zz okay? DON'T FORGET ABOUT THE YY! Then he looks around again and slowly fades from view, like all the color faded to grey, then all the outlines of his features just slowly alpha-fade to zero.

>say nodles
(to AFrame)
There is no reply.

>look aframe
Aframe is looking pretty sharp there wearing a pin-striped suit with his usual aplomb.

>aframe, remove suit
He gives this double-wink thing - like winking with one eye twice then the other once then both at the same time then rolls his eyes up then blinks both eyes again. That's the secret code you know cause you're buds.
AFrame takes off the pin-striped suit.

>take suit
That seems to belong to AFrame.

>look aframe
Aframe is looking pretty sharp there wearing a pink thong with his usual aplomb.

>aframe, remove thing
There is no reply.

>aframe, remove pink thong
He gives this double-wink thing - like winking with one eye twice then the other once then both at the same time then rolls his eyes up then blinks both eyes again. That's the secret code you know cause you're buds.
AFrame takes off the pink thong.

>look aframe
Aframe is looking pretty sharp there wearing nothing with his usual aplomb.

>aframe, remove usual aplomb
There is no reply.

>aframe, beer
There is no reply.

>aframe, yy
There is no reply.

>aframe, zz
There is no reply.

>aframe, exit
He gives this double-wink thing - like winking with one eye twice then the other once then both at the same time then rolls his eyes up then blinks both eyes again. That's the secret code you know cause you're buds.
AFrame is unable to do that.

>aframe, dance
There is no reply.

>aframe, end
There is no reply.

>aframe, moonwalk
There is no reply.

>take book
Taken.

>take dolphin code
Taken.

>exit
But you aren't in anything at the moment.

>east
You can't go that way.

>west
You can't go that way.

>south
You can't go that way.

>up
You can't go that way.

>down
You can't go that way.

>sideways
That's not a verb I recognize.

>backflio
That's not a verb I recognize.

>backflip
That's not a verb I recognize.

>booth
That's not a verb I recognize.

>look
Secret Room
You are in the Secret Room. DON'T TELL ANYONE YOU WERE EVER HERE! It's really dark, you can't see much.

You can see AFrame here.

You can see no obvious exits.

(There are no routes out of this room.)

>examine wall
You can't see any such thing.

>look wall
You can't see any such thing.

>say i am in the secret room
(to AFrame)
There is no reply.

>look dolphin code
It is fish shaped, and vibrates - readout screen says "Status optimal".

>look book
"yzxxy" is the title, and the contents just say "Your Future Lies in Space" over and over again.

>yzxxy
Space Lounge
You are in the Space Lounge, rumored to be the center of The Resistance. "Why did I come here?" you briefly wonder before looking around.

You can see an airlock and a bartender here.

You can go east through the airlock to the Veranda Walkway from here.

(From here, you can move to east.)

Under the influence of the black rod, you pronounced "yzxxy" as Wizex-zi. You are glad there is some way out of that Secret Room!

>xxyzz
That's not a verb I recognize.

>xyzzy
you feel a whooshy sound enter your eyeball sockets and then your tummy flips over your groiny-place. WHOOOOOAAAA suddenly you find yourself trasported to the...

you feel a whooshy sound enter your eyeball sockets and then your tummy flips over your groiny-place. WHOOOOOAAAA suddenly you find yourself trasported to the...

Secret Room
You are in the Secret Room. DON'T TELL ANYONE YOU WERE EVER HERE! It's really dark, you can't see much.

You can see AFrame here.

You can see no obvious exits.

(There are no routes out of this room.)

Under the influence of the black rod, you pronounced "xyzzy" as Xhi-zee. You understand now that the purpose of the black rod is to bring people here, to the Secret Room.

>xyzyyx
That's not a verb I recognize.

>xyzzy
you feel a whooshy sound enter your eyeball sockets and then your tummy flips over your groiny-place. WHOOOOOAAAA suddenly you find yourself trasported to the...

you feel a whooshy sound enter your eyeball sockets and then your tummy flips over your groiny-place. WHOOOOOAAAA suddenly you find yourself trasported to the...

Secret Room
You are in the Secret Room. DON'T TELL ANYONE YOU WERE EVER HERE! It's really dark, you can't see much.

You can see AFrame here.

You can see no obvious exits.

(There are no routes out of this room.)

Under the influence of the black rod, you pronounced "xyzzy" as Xhi-zee. You understand now that the purpose of the black rod is to bring people here, to the Secret Room.

>yzxxy
Space Lounge
You are in the Space Lounge, rumored to be the center of The Resistance. "Why did I come here?" you briefly wonder before looking around.

You can see an airlock and a bartender here.

You can go east through the airlock to the Veranda Walkway from here.

(From here, you can move to east.)

Under the influence of the black rod, you pronounced "yzxxy" as Wizex-zi. You are glad there is some way out of that Secret Room!

>xxxxx
That's not a verb I recognize.

>yyyyy
That's not a verb I recognize.

>zzzzz
That's not a verb I recognize.

>go floating courtyard
You can't see any such thing.

>east
Veranda Walkway
Outside the Space Lounge you look out into the larger Raditree Building to see the pool with under a high ceiling. Consuite lies beyond the pool in the main courtyard. Boffers beat each other up in the fenced in section of the courtyard. A floating dolphin surveillance pod floats by making you twitch instintively to make your shiny wig come between the camera and your face.

You can see an airlock and a floating dolphin (closed) here.

You can go north, northeast, northwest, southeast, west through the airlock to the Space Lounge, up, and down from here.

(From here, you can move to north, northeast, northwest, southeast, west, up, and down.)

>up
You don't have wings or pyscho-kinetic levitation abilities or a hoverboard or anything to go up with.

>use dolphin
That's not a verb I recognize.

>ride dolphin
That's not a verb I recognize.

>enter dolphin
(the dolphin code)
That's not something you can enter.

>enter floating dolphin
You have access to the floating dolphin. Wow - you'll be able to go up above the courtyard now and see everything!

You can't get into the closed floating dolphin.

>open floating dolphin
(first unlocking the floating dolphin)
(with the dolphin code)
You open the floating dolphin.

>enter floating dolphin
You have access to the floating dolphin. Wow - you'll be able to go up above the courtyard now and see everything!

Go up!

>up
Floating Courtyard (in the floating dolphin)
The floating dolphin is transparent, but tints everything outside very faintly lavender.

This is amazing - you are up above everything and can see so much up here! There's a pool down below, and a fenced in courtyard with some kind of security gate system surrounding it, and Consuite.

You can go down to the Veranda Walkway from here.

(From here, you can move to down.)

>up
You can't go that way.

>up
You can't go that way.

>up again
I only understood you as far as wanting to (go) up.

>exit dolphin
I only understood you as far as wanting to exit.

>look ninja
This is a ninja outfit, it's black and has a hood that covers your face. It has pockets in it to store cool ninja gear. It has these sweet built in booties that muffle your footsteps as if you were a total ninja, which you totally are if you are wearing this outfit. You could sneak around a place with shadows without being detected if you were wearing this thing. You'd be so ninja.

The pocket contains nothing.

>wear ninja
You are a ninja! It feels like you could blend into the shadows, or maybe you ARE the shadows, this ninja outfit makes you feel super ninja-like

>look self
As good-looking as ever.

>exit floating dolphin
I only understood you as far as wanting to exit.

I beg your pardon?

>burn wig
This dangerous act would achieve little.

>shoot wig
(with the crazy looking gun)
ZAP! The wig twinkles out of existence!

>shoot self
(with the crazy looking gun)
That would be disastrous!

>i dont care
I only understood you as far as wanting to take inventory.

>shoot gun
What do you want to shoot the crazy looking gun at?

>shoot gun gun
What do you want to shoot the crazy looking gun at?

>shoot gun with gun
Nice trick if you can do it!

>shoot gun at mirror towards gun
You can't see any such thing.

>shoot foot
You can't see any such thing.

>shoot floating dolphin
(with the crazy looking gun)
ZAP! The floating dolphin twinkles out of existence! 

*** Run-time problem P61: Attempt to move the player off-stage.

* * *

>open airlock
You open the airlock.

>east
Veranda Walkway
Outside the Space Lounge you look out into the larger Raditree Building to see the pool with under a high ceiling. Consuite lies beyond the pool in the main courtyard. Boffers beat each other up in the fenced in section of the courtyard. A floating dolphin surveillance pod floats by making you twitch instintively to make your shiny wig come between the camera and your face.

You can see an airlock, a black rod, and a floating dolphin (closed) here.

You can go north, northeast, northwest, southeast, west through the airlock to the Space Lounge, up, and down from here.

(From here, you can move to north, northeast, northwest, southeast, west, up, and down.)

>wes
I didn't understand that sentence.

>west
Space Lounge
You are in the Space Lounge, rumored to be the center of The Resistance. "Why did I come here?" you briefly wonder before looking around.

You can see an airlock, a bar (on which are a glittery box (closed) and a Glowing Sphere), a chair, a bench, a bartender, a black ninja outfit, AFrame, and a Security bot here.

You can go east through the airlock to the Veranda Walkway from here.

(From here, you can move to east.)

>look at AFram
You can't see any such thing.

>look at Aframe
Aframe is looking pretty sharp there wearing a pin-striped suit with his usual aplomb.

>say hi
Whom do you want to say that to?

>say hi to Aframe
There is no reply.

>Aframe, hi
There is no reply.

>Aframe, Where am I?
There is no reply.

>Hit Aframe
Violence isn't the answer to this one.

>Tickle Aframe
I didn't understand that sentence.

>Aframe, Take off suit
He says "sure, anything for a laugh!"
AFrame takes off the pin-striped suit.

>look at AFrame
Aframe is looking pretty sharp there wearing a pink thong with his usual aplomb.

>Aframe, take off thong
He says "sure, anything for a laugh!"
AFrame takes off the pink thong.

>look at Aframe
Aframe is looking pretty sharp there wearing nothing with his usual aplomb.

>xx
I didn't understand that sentence.

I beg your pardon?

>Aframe, XX?
There is no reply.

>Aframe, xx
There is no reply.

>ask aframe xx
I didn't understand that sentence.

>Ask afram about xx
You can't see any such thing.

>Ask Afram about xx
You can't see any such thing.

>Ask Aframe about xx
When you mention xx, Aframe's eyes light up. He smiles and looks around the room for a second before stepping closer to you. "How do you know aobut xx?", he says - well it doesn't matter now - just remember yy when you get to the zz okay? DON'T FORGET ABOUT THE YY! Then he looks around again and slowly fades from view, like all the color faded to grey, then all the outlines of his features just slowly alpha-fade to zero.

>take thong
You can't see any such thing.

>look
Space Lounge
You are in the Space Lounge, rumored to be the center of The Resistance. "Why did I come here?" you briefly wonder before looking around.

You can see an airlock, a bar (on which are a glittery box (closed) and a Glowing Sphere), a chair, a bench, a bartender, a black ninja outfit, and a Security bot here.

You can go east through the airlock to the Veranda Walkway from here.

(From here, you can move to east.)

>take black ninja outfit
Taken.

>wear black ninja outfit
You are a ninja! It feels like you could blend into the shadows, or maybe you ARE the shadows, this ninja outfit makes you feel super ninja-like

>look
Space Lounge
You are in the Space Lounge, rumored to be the center of The Resistance. "Why did I come here?" you briefly wonder before looking around.

You can see an airlock, a bar (on which are a glittery box (closed) and a Glowing Sphere), a chair, a bench, a bartender, and a Security bot here.

You can go east through the airlock to the Veranda Walkway from here.

(From here, you can move to east.)

>look at Security Bot
Looks like a standard security bot.

>hit security bot
Violence isn't the answer to this one.

>look box
Time slows down, you feel as if you gazing into the cosmos itself. Your eyeballs can hardly stay on it, it's like your gaze just keeps sliding off.

* * *

>take readout
Taken.

>read readout
The screen is blank.

The security readout is currently switched off.

>turn out readout
I only understood you as far as wanting to turn outside.

>turn on readout
You switch the security readout on.

>read readout
The screen reads: 

 airlock (Space Lounge/Veranda Walkway): UNLOCKED

>look at security readout
The screen reads: 

 airlock (Space Lounge/Veranda Walkway): UNLOCKED

>take bowl
Taken.

>look at bowl
The bowl is kind of unremarkable, not really exciting like some cool crazy gun would be or something.

In the bowl is a note.

>take note
Taken.

* * *

>read note
Cast the secret spell xyzzy

>Cast xyzzy
You are unable to articulate the second "z" separately from the first, and the spell fails in a disdainful puff. If only you had some sort of magical item to focus your arcane arts upon to increase your attunement to the fey realm.

>take gun
You have no idea what this gun does. You've never seen anything like it! You're pretty stoked to get this gun.

Taken.

>point gun
I didn't understand that sentence.

>look at gun
That gun is so crazy looking! It's kind of like totally blowing your mind.

>shoot gun
What do you want to shoot the crazy looking gun at?

>shoot gun at security bot
ZAP! The Security bot twinkles out of existence!

>look
Space Lounge
You are in the Space Lounge, rumored to be the center of The Resistance. "Why did I come here?" you briefly wonder before looking around.

You can see an airlock, a bar (on which are a glittery box (empty) and a Glowing Sphere), a chair, a bench, and a bartender here.

You can go east through the airlock to the Veranda Walkway from here.

(From here, you can move to east.)

>look at sphere
OOOOoooo glowy-sphere thingie! Its purple soft glow makes you feel safe and secure. It looks like there's some sort of helix-key as a component to the glowy-ness but it's unclear how you would remove it.

>take sphere
That's fixed in place.

>cast xyzzy at sphere
I didn't understand that sentence.

>look bartender
The bartender is making a glow in the dark smoothie.

>Bartender Hello
I didn't understand that sentence.

>Bartender hi
I didn't understand that sentence.

>look
Space Lounge
You are in the Space Lounge, rumored to be the center of The Resistance. "Why did I come here?" you briefly wonder before looking around.

You can see an airlock, a bar (on which are a glittery box (empty) and a Glowing Sphere), a chair, a bench, and a bartender here.

You can go east through the airlock to the Veranda Walkway from here.

(From here, you can move to east.)

>look bartender
The bartender is serving some smoothies.

>look bartender
The bartender is talking with a friend.

* * *

>look bartender
The bartender is serving some smoothies.

>look bartender
The bartender is standing there looking you over.

>shoot bartender
(with the crazy looking gun)
The weird ray somehow seems to bend around the bartender and disperses into a cloud of neon-swirled rainbow shards. She looks at you with a strange smirky side-eye. She must be wearing some kind of personal ray-deflector device. "splick", you admire-think.

>east
Veranda Walkway
Outside the Space Lounge you look out into the larger Raditree Building to see the pool with under a high ceiling. Consuite lies beyond the pool in the main courtyard. Boffers beat each other up in the fenced in section of the courtyard. A floating dolphin surveillance pod floats by making you twitch instintively to make your shiny wig come between the camera and your face.

You can see an airlock, a black rod, and a floating dolphin (closed) here.

You can go north, northeast, northwest, southeast, west through the airlock to the Space Lounge, up, and down from here.

(From here, you can move to north, northeast, northwest, southeast, west, up, and down.)

>west
Space Lounge
You are in the Space Lounge, rumored to be the center of The Resistance. "Why did I come here?" you briefly wonder before looking around.

You can see an airlock, a bar (on which are a glittery box (empty) and a Glowing Sphere), a chair, a bench, and a bartender here.

You can go east through the airlock to the Veranda Walkway from here.

(From here, you can move to east.)

>sit bench
I didn't understand that sentence.

>sit ON bench
You get onto the bench.

>look
Space Lounge (on the bench)
You are in the Space Lounge, rumored to be the center of The Resistance. "Why did I come here?" you briefly wonder before looking around.

You can see an airlock, a bar (on which are a glittery box (empty) and a Glowing Sphere), a chair, and a bartender here.

You can go east through the airlock to the Veranda Walkway from here.

(From here, you can move to east.)

>lay on bench
I didn't understand that sentence.

>get off bench
You get off the bench.

Space Lounge
You are in the Space Lounge, rumored to be the center of The Resistance. "Why did I come here?" you briefly wonder before looking around.

You can see an airlock, a bar (on which are a glittery box (empty) and a Glowing Sphere), a chair, a bench, and a bartender here.

You can go east through the airlock to the Veranda Walkway from here.

(From here, you can move to east.)

>sit in chair
Oh boy this chair looks really soft and comfy! Ooooh ya you are totally gonna sit on this chair big time.

You sit down and are so comfortable - you could really get used to being in this chair. Really! Wowsers...it's just the comfiest thing you probably ever plopped yer can on...it's like you're almost part of this thing...like your skin is melding with it and your insides are turning to some sort of tiny little beans...or a kind of foam batting material...

"What a lovely soft and dreamy world", you think. Nothing is wrong and everything is right. Right and soft. Sooooo sooooofffft.

>get out of chair
I only understood you as far as wanting to get outside.

>stand up
You'd rather be asleep. Whatever other thing you would do besides being in this chair is a bad idea and not really that good of an option compared to being in this insanely comfy chair.

"What a lovely soft and dreamy world", you think. Nothing is wrong and everything is right. Right and soft. Sooooo sooooofffft.

>shoot chair
(with the crazy looking gun)
You'd rather be asleep. Whatever other thing you would do besides being in this chair is a bad idea and not really that good of an option compared to being in this insanely comfy chair.

"What a lovely soft and dreamy world", you think. Nothing is wrong and everything is right. Right and soft. Sooooo sooooofffft.

>help
Space Lounge (on the chair)
You are in the Space Lounge, rumored to be the center of The Resistance. "Why did I come here?" you briefly wonder before looking around.

You can see an airlock, a bar (on which are a glittery box (empty) and a Glowing Sphere), a bench, and a bartender here.

You can go east through the airlock to the Veranda Walkway from here.

(From here, you can move to east.)

>get off chair
You just can't get up, you are way too comfortable! Maybe if you just stayed here in this chair forever you would be better off than whatever else you were going to do. Does it really matter?

"What a lovely soft and dreamy world", you think. Nothing is wrong and everything is right. Right and soft. Sooooo sooooofffft.

* * *

>get off chair
You try to heave yourself up, but the soft lusciousness of the chair envelopes you and pulls you back into its comfy folds. Oooooo...so comfy...so sooooooofffffft...

"What a lovely soft and dreamy world", you think. Nothing is wrong and everything is right. Right and soft. Sooooo sooooofffft.

>get off chair
Whew! You just barely escaped that chair, it's so comfy you could get stuck in it forever!

>east
Veranda Walkway
Outside the Space Lounge you look out into the larger Raditree Building to see the pool with under a high ceiling. Consuite lies beyond the pool in the main courtyard. Boffers beat each other up in the fenced in section of the courtyard. A floating dolphin surveillance pod floats by making you twitch instintively to make your shiny wig come between the camera and your face.

You can see an airlock, a black rod, and a floating dolphin (closed) here.

You can go north, northeast, northwest, southeast, west through the airlock to the Space Lounge, up, and down from here.

(From here, you can move to north, northeast, northwest, southeast, west, up, and down.)

>look at rod
A three foot black rod with a rusty star on one end lies nearby.

>take rod
Taken.

>wave rod
You wave the black rod.

>shoot rod
(with the crazy looking gun)
ZAP! The black rod twinkles out of existence!

>shoot dolphin
(with the crazy looking gun)
ZAP! The floating dolphin twinkles out of existence!

>west
Space Lounge
You are in the Space Lounge, rumored to be the center of The Resistance. "Why did I come here?" you briefly wonder before looking around.

You can see an airlock, a bar (on which are a glittery box (empty) and a Glowing Sphere), a chair, a bench, and a bartender here.

You can go east through the airlock to the Veranda Walkway from here.

(From here, you can move to east.)

>shoot sphere
(with the crazy looking gun)
ZAP! The Glowing Sphere twinkles out of existence! The security key clatters to the ground!

* * *

>take key
Taken.

>look at key
This looks like a standard tetral-inverse double helix security key with triple-blind encryption. Probably used to access airlocks n-schtoff.

>east
Veranda Walkway
Outside the Space Lounge you look out into the larger Raditree Building to see the pool with under a high ceiling. Consuite lies beyond the pool in the main courtyard. Boffers beat each other up in the fenced in section of the courtyard. A floating dolphin surveillance pod floats by making you twitch instintively to make your shiny wig come between the camera and your face.

You can see an airlock here.

You can go north, northeast, northwest, southeast, west through the airlock to the Space Lounge, up, and down from here.

(From here, you can move to north, northeast, northwest, southeast, west, up, and down.)

>dow
I didn't understand that sentence.

>down
Under the Veranda Walkway
Under the Veranda Walkway

You can go north, northeast, southeast, east, west, and up to the Veranda Walkway from here.

(From here, you can move to north, northeast, southeast, east, west, and up.)

>west
Crescent Kitchen
Food and Beer for sale

You can go northeast and east to Under the Veranda Walkway from here.

(From here, you can move to northeast and east.)

>buy food
You can't see any such thing.

>buy beer
You can't see any such thing.

>northeast
Lower Floor Changer
Lower elevators, escalators and stairwell lower level

You can go north, northeast, northwest, south to Under the Veranda Walkway, southwest to Crescent Kitchen, west, and up from here.

(From here, you can move to north, northeast, northwest, south, southwest, west, and up.)

>south
Under the Veranda Walkway
Under the Veranda Walkway

You can go north to the Lower Floor Changer, northeast, southeast, east, west to Crescent Kitchen, and up to the Veranda Walkway from here.

(From here, you can move to north, northeast, southeast, east, west, and up.)

>east
Garden Court
Garden Court

You can go west to Under the Veranda Walkway from here.

(From here, you can move to west.)

>west
Under the Veranda Walkway
Under the Veranda Walkway

You can go north to the Lower Floor Changer, northeast, southeast, east to the Garden Court, west to Crescent Kitchen, and up to the Veranda Walkway from here.

(From here, you can move to north, northeast, southeast, east, west, and up.)

>up
Veranda Walkway
Outside the Space Lounge you look out into the larger Raditree Building to see the pool with under a high ceiling. Consuite lies beyond the pool in the main courtyard. Boffers beat each other up in the fenced in section of the courtyard. A floating dolphin surveillance pod floats by making you twitch instintively to make your shiny wig come between the camera and your face.

You can see an airlock here.

You can go north, northeast, northwest, southeast, west through the airlock to the Space Lounge, up, and down to Under the Veranda Walkway from here.

(From here, you can move to north, northeast, northwest, southeast, west, up, and down.)

>up
You don't have wings or pyscho-kinetic levitation abilities or a hoverboard or anything to go up with.

>shoot boffers
You can't see any such thing.

>north
Floor Changer
Elevators, escalators, and stairwell.

You can go northeast, northwest, south to the Veranda Walkway, east, west, and down to the Lower Floor Changer from here.

(From here, you can move to northeast, northwest, south, east, west, and down.)

>south
Veranda Walkway
Outside the Space Lounge you look out into the larger Raditree Building to see the pool with under a high ceiling. Consuite lies beyond the pool in the main courtyard. Boffers beat each other up in the fenced in section of the courtyard. A floating dolphin surveillance pod floats by making you twitch instintively to make your shiny wig come between the camera and your face.

You can see an airlock here.

You can go north to the Floor Changer, northeast, northwest, southeast, west through the airlock to the Space Lounge, up, and down to Under the Veranda Walkway from here.

(From here, you can move to north, northeast, northwest, southeast, west, up, and down.)

>southeast
Upper Southside Hallway
This hallway is NUTS - there are signs everywhere and lights and sounds flashing. From this hallway you can get into a bunch of Party Rooms

You can go north, northeast, northwest to the Veranda Walkway, south, southeast, and southwest from here.

(From here, you can move to north, northeast, northwest, south, southeast, and southwest.)

>southeast
Round1
Welcome to Trivia, I'm your host, the disembodied voice coming from your device. We have only one rule; please don't cheat. Questions will be simple this round being worth five points a piece, but will increase in both difficulty and value as the game goes on. 

You can go northwest to the Upper Southside Hallway from here.

(From here, you can move to northwest.)

Kim Jong Il, Joseph Stalin, or Mao Tsedong, which dictator ruled the longest?

Please enter your answer

>Mao Tsedong
Well done.  Next question.

According to the Old Testament, who spent 3 days and nights in the belly of a whale?

Please enter your answer

>Noah
Incorrect. Next question.

The Tom Green Show and 16 and Pregnant were originally aired on what network?

Please enter your answer

>MTV
Well done.  Next question.

The Soul and The Optima are both models by what auto make?

Please enter your answer

>Kia
That was Round One, now onto Round Two!

Round2
Now onto Round Two where the questions get slightly harder but are worth ten points a piece.

You can see no obvious exits.

(There are no routes out of this room.)

What movie has the Highland Games, a Witch, and Craig Ferguson as Lord Macintosh?

Please enter your answer

>Highlander
That was Round Two, now onto Round Three!

Round3
Round Three is here! The questions are harder but now worth fifteen points a piece.

You can see no obvious exits.

(There are no routes out of this room.)

Ebony and Ivory was a duet performed by Stevie Wonder and what former Beatle?

Please enter your answer

>John Lennon
That was Round Three, now onto Round Four!

Round4
This is it, the final round. Europe's The Final Countdown is now playing on loop in your head and the questions are worth a whopping twenty points a piece.

You can see no obvious exits.

(There are no routes out of this room.)

Double Think and Cold War are both terms created by what English Author?

Please enter your answer

>Douglas Adams
Incorrect. Next question.

What actor or actress was in X-Men the Last Stand, Inception, and Juno? 

Please enter your answer

>Mariah Carey
Incorrect. Next question.

Spteznaz is an umbrella term for special forces from what country?

Please enter your answer

>Russia
Well done.  Next question.

CVX is the stock ticker symbol for what energy giant?

Please enter your answer

>Convergence
Incorrect. That was the end of Round Four.

End
Final Score: 35/200

You can go northeast to the Upper Southside Hallway from here.

(From here, you can move to northeast.)

>i
You're carrying a quizinator2, a security key, a crazy looking gun, a note, a bowl, a security readout, and a coin. You're wearing a black ninja outfit and a wig.

[Your score has just gone up by thirty-five points.]

>look at quizinator2
You got this for bad quizinating.

>look
End
Final Score: 35/200

You can go northeast to the Upper Southside Hallway from here.

(From here, you can move to northeast.)

>northeast
Upper Southside Hallway
This hallway is NUTS - there are signs everywhere and lights and sounds flashing. From this hallway you can get into a bunch of Party Rooms

You can go north, northeast, northwest to the Veranda Walkway, south, southeast to the Round1, and southwest to the End from here.

(From here, you can move to north, northeast, northwest, south, southeast, and southwest.)

>restart
Are you sure you want to restart?

>yes
In the early 2000"s, mewonkind's folly led to the breakdown of society and the restructuring of general cultural and technological vector-goals. At least that's what you were taught in data-download segment 2-histori-political info part 27A while syncing the standard edu-packets back in school. Now though, you find yourself inside of the massive hive known as CONvergence.

N is one.

Today's magic number is boring.

X is eleven!

Splounge-Dystopia
Watch your back, and don't let the cams spy your face. by Aaron Prust
Release 1 / Serial number 171129 / Inform 7 build 6M62 (I6/v6.33 lib 6/12N) SD

Space Lounge
You are in the Space Lounge, rumored to be the center of The Resistance. "Why did I come here?" you briefly wonder before looking around.

You can see an airlock, a bar (on which are a glittery box (closed) and a Glowing Sphere), a chair, a bench, a bartender, a black ninja outfit, AFrame, and a Security bot here.

You can go east through the airlock (closed) from here.

>east
(first opening the airlock)

Veranda Walkway
Outside the Space Lounge you look out into the larger Raditree Building to see the pool with under a high ceiling. Consuite lies beyond the pool in the main courtyard. Boffers beat each other up in the fenced in section of the courtyard. A floating dolphin surveillance pod floats by making you twitch instintively to make your shiny wig come between the camera and your face.

You can see an airlock, a black rod, and a floating dolphin (closed) here.

You can go north, northeast, northwest, southeast, west through the airlock to the Space Lounge, up, and down from here.

>take rod
Taken.

>shoot rod
What do you want to shoot the black rod with?

>swing rod
There's nothing sensible to swing here.

>xyzzy rod
I only understood you as far as wanting to xyzzy.

>xyzzy at rod
I only understood you as far as wanting to xyzzy.

>cast xyzzy
you feel a whooshy sound enter your eyeball sockets and then your tummy flips over your groiny-place. WHOOOOOAAAA suddenly you find yourself trasported to the...

you feel a whooshy sound enter your eyeball sockets and then your tummy flips over your groiny-place. WHOOOOOAAAA suddenly you find yourself trasported to the...

Secret Room
You are in the Secret Room. DON'T TELL ANYONE YOU WERE EVER HERE! It's really dark, you can't see much.

You can see a dolphin code and a book here.

You can see no obvious exits.

(There are no routes out of this room.)

Under the influence of the black rod, you pronounced "xyzzy" as Xhi-zee. You understand now that the purpose of the black rod is to bring people here, to the Secret Room.

>look at book
"yzxxy" is the title, and the contents just say "Your Future Lies in Space" over and over again.

>look at code
It is fish shaped, and vibrates - readout screen says "Status optimal".

>take code
Taken.

>take book
Taken.

>eat fish
You can't see any such thing.

>eat code
That's plainly inedible.

>xyzzy
you feel a whooshy sound enter your eyeball sockets and then your tummy flips over your groiny-place. WHOOOOOAAAA suddenly you find yourself trasported to the...

you feel a whooshy sound enter your eyeball sockets and then your tummy flips over your groiny-place. WHOOOOOAAAA suddenly you find yourself trasported to the...

Secret Room
You are in the Secret Room. DON'T TELL ANYONE YOU WERE EVER HERE! It's really dark, you can't see much.

You can see no obvious exits.

(There are no routes out of this room.)

Under the influence of the black rod, you pronounced "xyzzy" as Xhi-zee. You understand now that the purpose of the black rod is to bring people here, to the Secret Room.

>read book
"yzxxy" is the title, and the contents just say "Your Future Lies in Space" over and over again.

>use code on book
I didn't understand that sentence.

>code book
I didn't understand that sentence.

>decode book
I didn't understand that sentence.

>shake code
I didn't understand that sentence.

>throw book
Dropped.

>pick up book
Taken.

>yzxxy
Space Lounge
You are in the Space Lounge, rumored to be the center of The Resistance. "Why did I come here?" you briefly wonder before looking around.

You can see an airlock, a bar (on which are a glittery box (closed) and a Glowing Sphere), a chair, a bench, a bartender, a black ninja outfit, AFrame, and a Security bot here.

You can go east through the airlock to the Veranda Walkway from here.

(From here, you can move to east.)

Under the influence of the black rod, you pronounced "yzxxy" as Wizex-zi. You are glad there is some way out of that Secret Room!

>open box
You open the glittery box, revealing a security readout, a bowl, and a crazy looking gun.

* * *

>take gun
You have no idea what this gun does. You've never seen anything like it! You're pretty stoked to get this gun.

Taken.

>ask aframe about xx
When you mention xx, Aframe's eyes light up. He smiles and looks around the room for a second before stepping closer to you. "How do you know aobut xx?", he says - well it doesn't matter now - just remember yy when you get to the zz okay? DON'T FORGET ABOUT THE YY! Then he looks around again and slowly fades from view, like all the color faded to grey, then all the outlines of his features just slowly alpha-fade to zero.

>xyzzy
you feel a whooshy sound enter your eyeball sockets and then your tummy flips over your groiny-place. WHOOOOOAAAA suddenly you find yourself trasported to the...

you feel a whooshy sound enter your eyeball sockets and then your tummy flips over your groiny-place. WHOOOOOAAAA suddenly you find yourself trasported to the...

Secret Room
You are in the Secret Room. DON'T TELL ANYONE YOU WERE EVER HERE! It's really dark, you can't see much.

You can see AFrame here.

You can see no obvious exits.

(There are no routes out of this room.)

Under the influence of the black rod, you pronounced "xyzzy" as Xhi-zee. You understand now that the purpose of the black rod is to bring people here, to the Secret Room.

>ask aframe about xx
When you mention xx, Aframe's eyes light up. He smiles and looks around the room for a second before stepping closer to you. "How do you know aobut xx?", he says - well it doesn't matter now - just remember yy when you get to the zz okay? DON'T FORGET ABOUT THE YY! Then he looks around again and slowly fades from view, like all the color faded to grey, then all the outlines of his features just slowly alpha-fade to zero.

>shoot aframe
(with the crazy looking gun)
This weird ray comes out of your gun but it's like it's moving in slow-motion...as the beam wiggles toward Aframe super duper slow he steps out of the way of it. The wiggling intensifies and disappears. Aframe is looking at you with this annoyed look. Like he doesn't totally trust you anymore because you just tried to twinkle him out of existence.

>ask aframe about xx
When you mention xx, Aframe's eyes light up. He smiles and looks around the room for a second before stepping closer to you. "How do you know aobut xx?", he says - well it doesn't matter now - just remember yy when you get to the zz okay? DON'T FORGET ABOUT THE YY! Then he looks around again and slowly fades from view, like all the color faded to grey, then all the outlines of his features just slowly alpha-fade to zero.

>restart
Are you sure you want to restart?

>yes
In the early 2000"s, mewonkind's folly led to the breakdown of society and the restructuring of general cultural and technological vector-goals. At least that's what you were taught in data-download segment 2-histori-political info part 27A while syncing the standard edu-packets back in school. Now though, you find yourself inside of the massive hive known as CONvergence.

N is more than the number of your toes.

Six is the magic number!

X is eleven!

Splounge-Dystopia
Watch your back, and don't let the cams spy your face. by Aaron Prust
Release 1 / Serial number 171129 / Inform 7 build 6M62 (I6/v6.33 lib 6/12N) SD

Space Lounge
You are in the Space Lounge, rumored to be the center of The Resistance. "Why did I come here?" you briefly wonder before looking around.

You can see an airlock, a bar (on which are a glittery box (closed) and a Glowing Sphere), a chair, a bench, a bartender, a black ninja outfit, AFrame, and a Security bot here.

You can go east through the airlock (closed) from here.

>open box
You open the glittery box, revealing a security readout, a bowl, and a crazy looking gun.

* * *

>open bo
You can't see any such thing.

>open box
You open the glittery box, revealing a security readout, a bowl, and a crazy looking gun.

* * *

>take gun
You have no idea what this gun does. You've never seen anything like it! You're pretty stoked to get this gun.

Taken.

>take note
Taken.

>take security
(the Security bot)
I don't suppose the Security bot would care for that.

>take security readout
Taken.

>look security readout
The screen is blank.

The security readout is currently switched off.

>turn on security readout
You switch the security readout on.

>look security readout
The screen reads: 

 airlock (Space Lounge/Veranda Walkway): LOCKED

>w
You can't go that way.

>look west
You see nothing unexpected in that direction.

>look
Space Lounge
You are in the Space Lounge, rumored to be the center of The Resistance. "Why did I come here?" you briefly wonder before looking around.

You can see an airlock, a bar (on which are a glittery box (in which is a bowl (empty)) and a Glowing Sphere), a chair, a bench, a bartender, a black ninja outfit, AFrame, and a Security bot here.

You can go east through the airlock (closed) from here.

(From here, you can move to east.)

>talk aframe
That's not a verb I recognize.

>aframe, hello
There is no reply.

>aframe, remove suit
He says "sure, anything for a laugh!"
AFrame takes off the pin-striped suit.

>ask aframe xx
I didn't understand that sentence.

* * *

>ask aframe about xx
When you mention xx, Aframe's eyes light up. He smiles and looks around the room for a second before stepping closer to you. "How do you know aobut xx?", he says - well it doesn't matter now - just remember yy when you get to the zz okay? DON'T FORGET ABOUT THE YY! Then he looks around again and slowly fades from view, like all the color faded to grey, then all the outlines of his features just slowly alpha-fade to zero.

>look
Space Lounge
You are in the Space Lounge, rumored to be the center of The Resistance. "Why did I come here?" you briefly wonder before looking around.

You can see an airlock, a bar (on which are a glittery box (in which is a bowl (empty)) and a Glowing Sphere), a chair, a bench, a bartender, a black ninja outfit, and a Security bot here.

You can go east through the airlock (closed) from here.

(From here, you can move to east.)

>shoot sphere with gun
ZAP! The Glowing Sphere twinkles out of existence! The security key clatters to the ground!

* * *

>take key
Taken.

>look
Space Lounge
You are in the Space Lounge, rumored to be the center of The Resistance. "Why did I come here?" you briefly wonder before looking around.

You can see an airlock, a bar (on which is a glittery box (in which is a bowl (empty))), a chair, a bench, a bartender, a black ninja outfit, and a Security bot here.

You can go east through the airlock (closed) from here.

(From here, you can move to east.)

>take ninja
Taken.

>security bot, follow me
There is no reply.

* * *

>open box
You open the glittery box, revealing a security readout, a bowl, and a crazy looking gun.

* * *

>w
Space Lounge
You are in the Space Lounge, rumored to be the center of The Resistance. "Why did I come here?" you briefly wonder before looking around.

You can see an airlock, a bar (on which is a glittery box (in which are a security readout and a bowl (in which is a note))), a chair, a bench, a bartender, and a black ninja costume here.

You can go east through the airlock to the Veranda Walkway from here.

(From here, you can move to east.)

>sit chair
I didn't understand that sentence.

* * *

>get up
You'd rather be asleep.

"What a lovely soft and dreamy world", you think. Nothing is wrong and everything is right. Right and soft. Sooooo sooooofffft.

>look
Space Lounge (on the chair)
You are in the Space Lounge, rumored to be the center of The Resistance. "Why did I come here?" you briefly wonder before looking around.

You can see an airlock, a bar (on which is a glittery box (in which are a security readout and a bowl (in which is a note))), a bench, a bartender, and a black ninja costume here.

You can go east through the airlock to the Veranda Walkway from here.

(From here, you can move to east.)

"What a lovely soft and dreamy world", you think. Nothing is wrong and everything is right. Right and soft. Sooooo sooooofffft.

>e
You'd rather be asleep.

"What a lovely soft and dreamy world", you think. Nothing is wrong and everything is right. Right and soft. Sooooo sooooofffft.

>get up from
What do you want to get up from?

>get up from chair
You just can't get up, you are way too comfortable!

"What a lovely soft and dreamy world", you think. Nothing is wrong and everything is right. Right and soft. Sooooo sooooofffft.

* * *

>get up from chair
"What a lovely soft and dreamy world", you think. Nothing is wrong and everything is right. Right and soft. Sooooo sooooofffft.

>stand up
You'd rather be asleep.

"What a lovely soft and dreamy world", you think. Nothing is wrong and everything is right. Right and soft. Sooooo sooooofffft.

>stand up
You'd rather be asleep.

"What a lovely soft and dreamy world", you think. Nothing is wrong and everything is right. Right and soft. Sooooo sooooofffft.

>get out of chair
I only understood you as far as wanting to get outside.

>get up from chair
Whew! You just barely escaped that chair, it's so comfy you could get stuck in it forever!

* * *

>take note
Taken.

>take readout
Taken.

>look readout
The screen is blank.

The security readout is currently switched off.

* * *

>turn on readout
You switch the security readout on.

>look readout
The screen reads: 

 airlock (Space Lounge/Veranda Walkway): LOCKED

>open airlock
(first unlocking the airlock)
You lack a key that fits the airlock.

>look
Space Lounge
You are in the Space Lounge, rumored to be the center of The Resistance. "Why did I come here?" you briefly wonder before looking around.

You can see an airlock, a bar (on which are a glittery box (in which is a bowl (empty)) and a Glowing Sphere), a chair, a bench, a bartender, and a black ninja costume here.

You can go east through the airlock (closed) from here.

(From here, you can move to east.)

>look sphere
OOOOoooo glowy-sphere thingie! Its purple soft glow makes you feel safe and secure. It looks like there's some sort of helix-key as a component to the glowy-ness but it's unclear how you would remove it.

>shoot sphere
(with the crazy looking gun)
ZAP! The Glowing Sphere twinkles out of existence! The security key clatters to the ground!

* * *

>take key
Taken.

>look
Space Lounge
You are in the Space Lounge, rumored to be the center of The Resistance. "Why did I come here?" you briefly wonder before looking around.

You can see an airlock, a bar (on which is a glittery box (in which is a bowl (empty))), a chair, a bench, a bartender, and a black ninja costume here.

You can go east through the airlock (closed) from here.

(From here, you can move to east.)

>take ninj
You can't see any such thing.

>take ninja
(the black ninja costume)
Taken.

>look bartender
You see a female bartender with neon hair and glowing robes serving drinks. The bartender is currently helping some other people but if you wait you can probably get a chance to talk to her.

>e
(first opening the airlock)
(first unlocking the airlock)
(with the security key)

Veranda Walkway
Outside the Space Lounge you look out into the larger Raditree Building to see the pool with under a high ceiling. Consuite lies beyond the pool in the main courtyard. Boffers beat each other up in the fenced in section of the courtyard. A floating dolphin surveillance pod floats by making you twitch instintively to make your shiny wig come between the camera and your face.

You can see an airlock, a black rod, and a floating dolphin (closed) here.

You can go north, northeast, northwest, southeast, west through the airlock to the Space Lounge, up, and down from here.

(From here, you can move to north, northeast, northwest, southeast, west, up, and down.)

>look dolphin
Oh crap - the floating dolphin's survellance cam is honing in on you! You better get out of here, somewhere where the floating dolphin camera can't see you.

>open dolphin
(first unlocking the floating dolphin)
You lack a key that fits the floating dolphin.

>look self
As good-looking as ever.

>i
You're carrying a black ninja costume, a security key, a security readout, a note, and a crazy looking gun. You're wearing a wig.

>look wig
This wig is super shiny and silvery, reflecting light off in all directions, it helps you avoid being face-detected by the intero-pods.

>take rod
Taken.

>xyzzy
you feel a whooshy sound enter your eyeball sockets and then your tummy flips over your groiny-place. WHOOOOOAAAA suddenly you find yourself trasported to the...

you feel a whooshy sound enter your eyeball sockets and then your tummy flips over your groiny-place. WHOOOOOAAAA suddenly you find yourself trasported to the...

Secret Room
You are in the Secret Room. DON'T TELL ANYONE YOU WERE EVER HERE! It's really dark, you can't see much.

You can see a dolphin code and a book here.

You can see no obvious exits.

(There are no routes out of this room.)

Under the influence of the black rod, you pronounced "xyzzy" as Xhi-zee. You understand now that the purpose of the black rod is to bring people here, to the Secret Room.

>look book
"yzxxy" is the title, and the contents just say "Your Future Lies in Space" over and over again.

>take code
Taken.

* * *

>take book
Taken.

>yzxxy
Space Lounge
You are in the Space Lounge, rumored to be the center of The Resistance. "Why did I come here?" you briefly wonder before looking around.

You can see an airlock, a bar (on which is a glittery box (in which is a bowl (empty))), a chair, a bench, and a bartender here.

You can go east through the airlock to the Veranda Walkway from here.

(From here, you can move to east.)

Under the influence of the black rod, you pronounced "yzxxy" as Wizex-zi. You are glad there is some way out of that Secret Room!

>e
Veranda Walkway
Outside the Space Lounge you look out into the larger Raditree Building to see the pool with under a high ceiling. Consuite lies beyond the pool in the main courtyard. Boffers beat each other up in the fenced in section of the courtyard. A floating dolphin surveillance pod floats by making you twitch instintively to make your shiny wig come between the camera and your face.

You can see an airlock and a floating dolphin (closed) here.

You can go north, northeast, northwest, southeast, west through the airlock to the Space Lounge, up, and down from here.

(From here, you can move to north, northeast, northwest, southeast, west, up, and down.)

>enter dolphin
(the dolphin code)
That's not something you can enter.

>open dolphin
(the dolphin code)
It isn't something you can open.

>open floathing dolphin
You can't see any such thing.

>open floatin dolphin
You can't see any such thing.

>open floating dolphin
(first unlocking the floating dolphin)
(with the dolphin code)
You open the floating dolphin.

* * *

>up
Floating Courtyard (in the floating dolphin)
The floating dolphin is transparent, but tints everything outside very faintly lavender.

This is amazing - you are up above everything and can see so much up here! There's a pool down below, and a fenced in courtyard with some kind of security gate system surrounding it, and Consuite.

You can go down to the Veranda Walkway from here.

(From here, you can move to down.)

>d
Veranda Walkway (in the floating dolphin)
The floating dolphin is transparent, but tints everything outside very faintly lavender.

Outside the Space Lounge you look out into the larger Raditree Building to see the pool with under a high ceiling. Consuite lies beyond the pool in the main courtyard. Boffers beat each other up in the fenced in section of the courtyard. A floating dolphin surveillance pod floats by making you twitch instintively to make your shiny wig come between the camera and your face.

You can see an airlock here.

You can go north, northeast, northwest, southeast, west through the airlock to the Space Lounge, up to the Floating Courtyard, and down from here.

(From here, you can move to north, northeast, northwest, southeast, west, up, and down.)

>se
Upper Southside Hallway (in the floating dolphin)
The floating dolphin is transparent, but tints everything outside very faintly lavender.

This hallway is NUTS - there are signs everywhere and lights and sounds flashing. From this hallway you can get into a bunch of Party Rooms

You can go north, northeast, northwest to the Veranda Walkway, and south from here.

(From here, you can move to north, northeast, northwest, and south.)

>ne
Consuite (in the floating dolphin)
The floating dolphin is transparent, but tints everything outside very faintly lavender.

You can go northwest, southwest to the Upper Southside Hallway, and down from here.

(From here, you can move to northwest, southwest, and down.)

>exit dolphin
I only understood you as far as wanting to exit.

>leave dolphin
I only understood you as far as wanting to leave.

>get out of floating dolphin
I only understood you as far as wanting to get outside.

>exit floating dolphin
I only understood you as far as wanting to exit.

>d
Under Consuite (in the floating dolphin)
The floating dolphin is transparent, but tints everything outside very faintly lavender.

Under Consuite

You can go northwest, southwest, west, and up to Consuite from here.

(From here, you can move to northwest, southwest, west, and up.)

>nw
Lower Northside Hallway (in the floating dolphin)
The floating dolphin is transparent, but tints everything outside very faintly lavender.

Lower Northside Hallway (party rooms)

You can go north, southeast to Under Consuite, and southwest from here.

(From here, you can move to north, southeast, and southwest.)

>sw
Under the Veranda Walkway (in the floating dolphin)
The floating dolphin is transparent, but tints everything outside very faintly lavender.

Under the Veranda Walkway

You can go north, northeast to Lower Northside Hallway, southeast, east, west, and up to the Veranda Walkway from here.

(From here, you can move to north, northeast, southeast, east, west, and up.)

>n
Lower Floor Changer (in the floating dolphin)
The floating dolphin is transparent, but tints everything outside very faintly lavender.

Lower elevators, escalators and stairwell lower level

You can go north, northeast, northwest, south to Under the Veranda Walkway, southwest, west, and up from here.

(From here, you can move to north, northeast, northwest, south, southwest, west, and up.)

>nw
Lower Tower Connector (in the floating dolphin)
The floating dolphin is transparent, but tints everything outside very faintly lavender.

The Lower Tower Connector - connection between the short and tall towers.

You can go southeast to the Lower Floor Changer from here.

(From here, you can move to southeast.)

>se
Lower Floor Changer (in the floating dolphin)
The floating dolphin is transparent, but tints everything outside very faintly lavender.

Lower elevators, escalators and stairwell lower level

You can go north, northeast, northwest to the Lower Tower Connector, south to Under the Veranda Walkway, southwest, west, and up from here.

(From here, you can move to north, northeast, northwest, south, southwest, west, and up.)

>n
Elevator Line (in the floating dolphin)
The floating dolphin is transparent, but tints everything outside very faintly lavender.

You are waiting for an elevator!

You can go south to the Lower Floor Changer from here.

(From here, you can move to south.)

>n
You can't go that way.

* * *

>put on ninja outfit
(first taking the black ninja outfit)
You are a ninja! It feels like you could blend into the shadows, or maybe you ARE the shadows, this ninja outfit makes you feel super ninja-like

>inspect glowing spear
I didn't understand that sentence.

>inspect glowing sphere
I didn't understand that sentence.

>look at glowing sphere
OOOOoooo glowy-sphere thingie! Its purple soft glow makes you feel safe and secure. It looks like there's some sort of helix-key as a component to the glowy-ness but it's unclear how you would remove it.

>high five Aframe
I didn't understand that sentence.

>look at helix-key
You can't see any such thing.

>talk to bartender
You say hello to the bartender.

>ask bartender about glowy sphere
"I'm afraid I haven't the faintest," The bartender comments huskily.

>bribe bartender
I didn't understand that sentence.

>hello, Aframe!
You are already talking to the bartender.

I didn't understand that sentence.

>look at bartender
The bartender is cleaning the blender.

(Health: 100)

>look at weapons
You can't see any such thing.

>i
You are carrying: 
a black ninja outfit
a coin
a wig
a dagger
(Health: 100)

>look at self
You are in perfect health. (Health: 100)

>look at ninja outfit
This is a ninja outfit, it's black and has a hood that covers your face. It has pockets in it to store cool ninja gear. It has these sweet built in booties that muffle your footsteps as if you were a total ninja, which you totally are if you are wearing this outfit. You could sneak around a place with shadows without being detected if you were wearing this thing. You'd be so ninja.

The pocket contains nothing.

>find ninja star
I didn't understand that sentence.

>look at Aframe
Aframe is looking pretty sharp there wearing a pin-striped suit with his usual aplomb.

(Health: 100)

>buy Aframe a drink
I only understood you as far as wanting to buy AFrame.

>ask Aframe to take off his suit
I didn't understand that sentence.

>Aframe, remove suit
He says "sure, anything for a laugh!"
AFrame takes off the pin-striped suit.

>look at Aframe
Aframe is looking pretty sharp there wearing a pink thong with his usual aplomb.

(Health: 100)

>Aframe, dance!
There is no reply.

>Aframe, remove suit
He says "sure, anything for a laugh!"

>Aframe, remove thong
He says "sure, anything for a laugh!"
AFrame takes off the pink thong.

>look at Aframe
Aframe is looking pretty sharp there wearing nothing with his usual aplomb.

(Health: 100)

>Cheer at Aframe
I didn't understand that sentence.

>ask Aframe about xx
When you mention xx, Aframe's eyes light up. He smiles and looks around the room for a second before stepping closer to you. "How do you know aobut xx?", he says - well it doesn't matter now - just remember yy when you get to the zz okay? DON'T FORGET ABOUT THE YY! Then he looks around again and slowly fades from view, like all the color faded to grey, then all the outlines of his features just slowly alpha-fade to zero.

>ask aframe about helix-key
You can't see any such thing.

>look
Space Lounge
You are in the Space Lounge. "Why did I come here?" you briefly wonder before looking around.

You can see an airlock, a bar (on which are a Glowing Sphere and a glittery box (closed)), a bench, a chair, a bartender, and a Security bot here.

You can go east through the airlock (closed) from here.

(From here, you can move to east.)

>look at security bot
Looks like a standard security bot.

(Health: 100)

>ask security bot about glowy sphere
There is no reply.

>look at glittery box
Time slows down, you feel as if you gazing into the cosmos itself. Your eyeballs can hardly stay on it, it's like your gaze just keeps sliding off.

>look away
You can't see any such thing.

>open bod
You can't see any such thing.

>open box
You open the glittery box, revealing a security readout, a bowl, and a crazy looking gun.

>look at security readout
The screen is blank.

The security readout is currently switched off.

>turn it on
You switch the security readout on.

>look at it
The screen reads: 

 airlock (Space Lounge/Veranda Walkway): UNLOCKED

>look at bowl
The bowl is kind of unremarkable, not really exciting like some cool crazy gun would be or something.

In the bowl is a note.

>read note
Cast the secret spell xyzzy

>look at gun
That gun is so crazy looking! It's kind of like totally blowing your mind.

>grab gun
I didn't understand that sentence.

>take gun
You have no idea what this gun does. You've never seen anything like it! You're pretty stoked to get this gun.

Taken.

>cast secret spell xyzzy
I didn't understand that sentence.

>cast xyzzy
You are unable to articulate the second "z" separately from the first, and the spell fails in a disdainful puff. If only you had some sort of magical item to focus your arcane arts upon to increase your attunement to the fey realm.

>focus on bowl
I didn't understand that sentence.

>focus on gun
I didn't understand that sentence.

>go to airlock
You can't see any such thing.

>look
Space Lounge
You are in the Space Lounge. "Why did I come here?" you briefly wonder before looking around.

You can see an airlock, a bar (on which are a Glowing Sphere and a glittery box (in which are a security readout and a bowl (in which is a note))), a bench, a chair, a bartender, and a Security bot here.

You can go east through the airlock (closed) from here.

(From here, you can move to east.)

>go east
(first opening the airlock)

Veranda Walkway
Outside the Space Lounge you look out into the larger Raditree Building to see the pool with under a high ceiling. Consuite lies beyond the pool in the main courtyard. Boffers beat each other up in the fenced in section of the courtyard. A floating dolphin surveillance pod floats by making you twitch instintively to make your shiny wig come between the camera and your face.

You can see an airlock, a black rod, and a floating dolphin (closed) here.

You can go north, northeast, northwest, southeast, west through the airlock to the Space Lounge, up, and down from here.

(From here, you can move to north, northeast, northwest, southeast, west, up, and down.)

>look at black rod
A three foot black rod with a rusty star on one end lies nearby.

>take black rod
Taken.

>look at floating dolphin
Oh crap - the floating dolphin's survellance cam is honing in on you! You better get out of here, somewhere where the floating dolphin camera can't see you.

>east
You can't go that way.

>go east
You can't go that way.

>go up
You don't have wings or pyscho-kinetic levitation abilities or a hoverboard or anything to go up with.

>go west
Space Lounge
You are in the Space Lounge. "Why did I come here?" you briefly wonder before looking around.

You can see an airlock, a bar (on which are a Glowing Sphere and a glittery box (in which are a security readout and a bowl (in which is a note))), a bench, a chair, a bartender, and a Security bot here.

You can go east through the airlock to the Veranda Walkway from here.

(From here, you can move to east.)

>east
Veranda Walkway
Outside the Space Lounge you look out into the larger Raditree Building to see the pool with under a high ceiling. Consuite lies beyond the pool in the main courtyard. Boffers beat each other up in the fenced in section of the courtyard. A floating dolphin surveillance pod floats by making you twitch instintively to make your shiny wig come between the camera and your face.

You can see an airlock and a floating dolphin (closed) here.

You can go north, northeast, northwest, southeast, west through the airlock to the Space Lounge, up, and down from here.

(From here, you can move to north, northeast, northwest, southeast, west, up, and down.)

>south
You can't go that way.

>go north
Floor Changer
Elevators, escalators, and stairwell.

You can go northeast, northwest, south to the Veranda Walkway, east, west, and down from here.

(From here, you can move to northeast, northwest, south, east, west, and down.)

>go down
Lower Floor Changer
Lower elevators, escalators and stairwell lower level

You can go north, northeast, northwest, south, southwest, west, and up to the Floor Changer from here.

(From here, you can move to north, northeast, northwest, south, southwest, west, and up.)

>go northeast
Stairwell Floor 1
Stairwell Floor 1

You can go southwest to the Lower Floor Changer and up from here.

(From here, you can move to southwest and up.)

>go southwest
Lower Floor Changer
Lower elevators, escalators and stairwell lower level

You can go north, northeast to the Stairwell Floor 1, northwest, south, southwest, west, and up to the Floor Changer from here.

(From here, you can move to north, northeast, northwest, south, southwest, west, and up.)

>go to consuit
You can't see any such thing.

>go to consuite
You can't see any such thing.

>go east
You can't go that way.

>go south
Under the Veranda Walkway
You can go north to the Lower Floor Changer, northeast, southeast, east, west, and up to the Veranda Walkway from here.

(From here, you can move to north, northeast, southeast, east, west, and up.)

>so u
I didn't understand that sentence.

>go u
Veranda Walkway
Outside the Space Lounge you look out into the larger Raditree Building to see the pool with under a high ceiling. Consuite lies beyond the pool in the main courtyard. Boffers beat each other up in the fenced in section of the courtyard. A floating dolphin surveillance pod floats by making you twitch instintively to make your shiny wig come between the camera and your face.

You can see an airlock and a floating dolphin (closed) here.

You can go north to the Floor Changer, northeast, northwest, southeast, west through the airlock to the Space Lounge, up, and down to Under the Veranda Walkway from here.

(From here, you can move to north, northeast, northwest, southeast, west, up, and down.)

>go southeast
Upper Southside Hallway
This hallway is NUTS - there are signs everywhere and lights and sounds flashing. From this hallway you can get into a bunch of Party Rooms

You can go north, northeast, northwest to the Veranda Walkway, south, southeast, and southwest from here.

(From here, you can move to north, northeast, northwest, south, southeast, and southwest.)

>go s
Staging Area
You can see a yellow jersey, a polkadot jersey, a green jersey, a white jersey, and a blue jersey here.

You can go north to the Upper Southside Hallway from here.

(From here, you can move to north.)

>look at jerseys
You can't use multiple objects with that verb.

>look at yellow jersey
Since 1919, the Tour de France has awarded this jersey to the race leader.

>look at polkadot jersey
Since 1933, the Tour de France has awarded this jersey to the King of the Mountains.

>look at green jersey
Since 1953, the Tour de France has awarded this jersey to the highest point scorer on sprints.

>look at white jersey
Since 1975, the Tour de France has awarded this jersey to the best cyclist aged 25 or less.

>look at blue jersey
blue jersaaaay

>go n
Upper Southside Hallway
This hallway is NUTS - there are signs everywhere and lights and sounds flashing. From this hallway you can get into a bunch of Party Rooms

You can go north, northeast, northwest to the Veranda Walkway, south to the Staging Area, southeast, and southwest from here.

(From here, you can move to north, northeast, northwest, south, southeast, and southwest.)

>go southeast
Round1
Welcome to Trivia, I'm your host, the disembodied voice coming from your device. We have only one rule; please don't cheat. Questions will be simple this round being worth five points a piece, but will increase in both difficulty and value as the game goes on. 

You can go northwest to the Upper Southside Hallway from here.

(From here, you can move to northwest.)

According to the Old Testament, who spent 3 days and nights in the belly of a whale?

Please enter your answer

>jonah
Incorrect. Next question.

The Tom Green Show and 16 and Pregnant were originally aired on what network?

Please enter your answer

>MTV
Well done.  Next question.

The Soul and The Optima are both models by what auto make?

Please enter your answer

>Kia
Well done.  Next question.

Kim Jong Il, Joseph Stalin, or Mao Tsedong, which dictator ruled the longest?

Please enter your answer

>Kim Jong II
That was Round One, now onto Round Two!

Round2
Now onto Round Two where the questions get slightly harder but are worth ten points a piece.

You can see no obvious exits.

(There are no routes out of this room.)

In the contract version of what card game are players identified by points on the compass?

Please enter your answer

>Bridge
Well done.  Next question.

What movie has the Highland Games, a Witch, and Craig Ferguson as Lord Macintosh?

Please enter your answer

>Braveheart
That was Round Two, now onto Round Three!

Round3
Round Three is here! The questions are harder but now worth fifteen points a piece.

You can see no obvious exits.

(There are no routes out of this room.)

In what year did Spongebob Squarepants premier on television, Wide Open Spaces by the Dixie Chicks won a Grammy, and the Sixth Sense premiered in theaters?

Please enter your answer

>shoot raygun
That was Round Three, now onto Round Four!

Round4
This is it, the final round. Europe's The Final Countdown is now playing on loop in your head and the questions are worth a whopping twenty points a piece.

You can see no obvious exits.

(There are no routes out of this room.)

CVX is the stock ticker symbol for what energy giant?

Please enter your answer

>CVX
Incorrect. Next question.

What actor or actress was in X-Men the Last Stand, Inception, and Juno? 

Please enter your answer

>hfh
Incorrect. Next question.

Spteznaz is an umbrella term for special forces from what country?

Please enter your answer

>Estonia
Incorrect. Next question.

Double Think and Cold War are both terms created by what English Author?

Please enter your answer

>George Orwell
Well done. That was the end of Round Four.

End
Final Score: 40/200

You can go northeast to the Upper Southside Hallway from here.

(From here, you can move to northeast.)

I didn't understand that sentence.

>look
End
Final Score: 40/200

You can go northeast to the Upper Southside Hallway from here.

(From here, you can move to northeast.)

[Your score has just gone up by forty points.]

>i
You are carrying: 
a quizinator2
a black rod
a crazy looking gun
a black ninja outfit
a coin
a wig
a dagger
(Health: 100)

>look at quizinator2
You got this for bad quizinating.

>cast xyzzy
you feel a whooshy sound enter your eyeball sockets and then your tummy flips over your groiny-place. WHOOOOOAAAA suddenly you find yourself trasported to the...

you feel a whooshy sound enter your eyeball sockets and then your tummy flips over your groiny-place. WHOOOOOAAAA suddenly you find yourself trasported to the...

Secret Room
You are in the Secret Room. DON'T TELL ANYONE YOU WERE EVER HERE! It's really dark, you can't see much.

You can see AFrame, a dolphin code, and a book here.

You can see no obvious exits.

(There are no routes out of this room.)

Under the influence of the black rod, you pronounced "xyzzy" as Xhi-zee. You understand now that the purpose of the black rod is to bring people here, to the Secret Room.

>talk to aframe about meaning of life
I only understood you as far as wanting to talk to AFrame.

>talk to aframe
You say hello to AFrame.

>look at aframe
Aframe is looking pretty sharp there wearing nothing with his usual aplomb.

(Health: 100)

>look at book
"yzxxy" is the title, and the contents just say "Your Future Lies in Space" over and over again.

>take book
Taken.

>look at dolphin code
It is fish shaped, and vibrates - readout screen says "Status optimal".

>take dolphin code
Taken.

>return to floating dolphin
I didn't understand that sentence.

>look
Secret Room
You are in the Secret Room. DON'T TELL ANYONE YOU WERE EVER HERE! It's really dark, you can't see much.

You can see AFrame here.

You can see no obvious exits.

(There are no routes out of this room.)

>read book
"yzxxy" is the title, and the contents just say "Your Future Lies in Space" over and over again.

>say "your future lies in space"
(to AFrame)
There is no reply.

>cast "your future lies in space"
I didn't understand that sentence.

>cast yzxxy
Space Lounge
You are in the Space Lounge. "Why did I come here?" you briefly wonder before looking around.

You can see an airlock, a bar (on which are a Glowing Sphere and a glittery box (in which are a security readout and a bowl (in which is a note))), a bench, a chair, a bartender, and a Security bot here.

You can go east through the airlock to the Veranda Walkway from here.

(From here, you can move to east.)

Under the influence of the black rod, you pronounced "yzxxy" as Wizex-zi. You are glad there is some way out of that Secret Room!

>go east
Veranda Walkway
Outside the Space Lounge you look out into the larger Raditree Building to see the pool with under a high ceiling. Consuite lies beyond the pool in the main courtyard. Boffers beat each other up in the fenced in section of the courtyard. A floating dolphin surveillance pod floats by making you twitch instintively to make your shiny wig come between the camera and your face.

You can see an airlock and a floating dolphin (closed) here.

You can go north to the Floor Changer, northeast, northwest, southeast to the Upper Southside Hallway, west through the airlock to the Space Lounge, up, and down to Under the Veranda Walkway from here.

(From here, you can move to north, northeast, northwest, southeast, west, up, and down.)

>use dolphin key
I didn't understand that sentence.

>i
You are carrying: 
a dolphin code
a book
a quizinator2
a black rod
a crazy looking gun
a black ninja outfit
a coin
a wig
a dagger
(Health: 100)

>open dolphin
(the dolphin code)
It isn't something you can open.

>open floating dolphin
(first unlocking the floating dolphin)
(with the dolphin code)
You open the floating dolphin.

>go inside
You can't go that way.

>go in
You can't go that way.

>get in
You have access to the floating dolphin. Wow - you'll be able to go up above the courtyard now and see everything!

Go up!

>go up
Floating Courtyard (in the floating dolphin)
The floating dolphin is transparent, but tints everything outside very faintly lavender.

This is amazing - you are up above everything and can see so much up here! There's a pool down below, and a fenced in courtyard with some kind of security gate system surrounding it, and Consuite.

You can go down to the Veranda Walkway from here.

(From here, you can move to down.)

>go down
Veranda Walkway (in the floating dolphin)
The floating dolphin is transparent, but tints everything outside very faintly lavender.

Outside the Space Lounge you look out into the larger Raditree Building to see the pool with under a high ceiling. Consuite lies beyond the pool in the main courtyard. Boffers beat each other up in the fenced in section of the courtyard. A floating dolphin surveillance pod floats by making you twitch instintively to make your shiny wig come between the camera and your face.

You can see an airlock here.

You can go north to the Floor Changer, northeast, northwest, southeast to the Upper Southside Hallway, west through the airlock to the Space Lounge, up to the Floating Courtyard, and down to Under the Veranda Walkway from here.

(From here, you can move to north, northeast, northwest, southeast, west, up, and down.)

>get out
You get out of the floating dolphin.

Veranda Walkway
Outside the Space Lounge you look out into the larger Raditree Building to see the pool with under a high ceiling. Consuite lies beyond the pool in the main courtyard. Boffers beat each other up in the fenced in section of the courtyard. A floating dolphin surveillance pod floats by making you twitch instintively to make your shiny wig come between the camera and your face.

You can see a floating dolphin (empty) and an airlock here.

You can go north to the Floor Changer, northeast, northwest, southeast to the Upper Southside Hallway, west through the airlock to the Space Lounge, up to the Floating Courtyard, and down to Under the Veranda Walkway from here.

(From here, you can move to north, northeast, northwest, southeast, west, up, and down.)

>look boffer
You can't see any such thing.

>go down
Under the Veranda Walkway
You can go north to the Lower Floor Changer, northeast, southeast, east, west, and up to the Veranda Walkway from here.

(From here, you can move to north, northeast, southeast, east, west, and up.)

>go northeast
Lower Northside Hallway
Lower Northside Hallway (party rooms)

You can go north, southeast, and southwest to Under the Veranda Walkway from here.

(From here, you can move to north, southeast, and southwest.)

>go sw
Under the Veranda Walkway
You can go north to the Lower Floor Changer, northeast to Lower Northside Hallway, southeast, east, west, and up to the Veranda Walkway from here.

(From here, you can move to north, northeast, southeast, east, west, and up.)

>go n
Lower Floor Changer
Lower elevators, escalators and stairwell lower level

You can go north, northeast to the Stairwell Floor 1, northwest, south to Under the Veranda Walkway, southwest, west, and up to the Floor Changer from here.

(From here, you can move to north, northeast, northwest, south, southwest, west, and up.)

>go s
Under the Veranda Walkway
You can go north to the Lower Floor Changer, northeast to Lower Northside Hallway, southeast, east, west, and up to the Veranda Walkway from here.

(From here, you can move to north, northeast, southeast, east, west, and up.)

>go w
Crescent Kitchen
Food and Beer for sale

You can go northeast to the Lower Floor Changer and east to Under the Veranda Walkway from here.

(From here, you can move to northeast and east.)

>buy beer
You can't see any such thing.

>get beer
You can't see any such thing.

>go to crescent kitchen
You can't see any such thing.

>go ne
Lower Floor Changer
Lower elevators, escalators and stairwell lower level

You can go north, northeast to the Stairwell Floor 1, northwest, south to Under the Veranda Walkway, southwest to Crescent Kitchen, west, and up to the Floor Changer from here.

(From here, you can move to north, northeast, northwest, south, southwest, west, and up.)

>look map
You can't see any such thing.

* * *

>reginald burgett horton III
Hi, reginald!

Aaaah, that's a good one..

Space Lounge
You are in the Space Lounge. It's dim and glowy all over with pulsating colors and subtle hypnotic sounds.

You can see an airlock, a black ninja outfit, a bar (on which are a Glowing Sphere and a glittery box (closed)), a bench, a chair, a bartender, AFrame, and a Security bot here.

You can go east through the airlock (closed) from here.

(From here, you can move to east.)

* * *

>s s
s s!? Aaaah, that's a good one.

Space Lounge
You are in the Space Lounge. It's dim and glowy all over with pulsating colors and subtle hypnotic sounds.

You can see an airlock, a black ninja outfit, a bar (on which are a Glowing Sphere and a glittery box (closed)), a bench, a chair, a bartender, AFrame, and a securityBot here.

You can go east through the airlock (closed) and west from here.

* * *

>se
se? Interesting, nice.

Space Lounge
You are in the Space Lounge. It's dim and glowy all over with pulsating colors and subtle hypnotic sounds.

You can see an airlock, a black ninja outfit, a bar (on which are a Glowing Sphere and a glittery box (closed)), a bench, a chair, a bartender, AFrame, and a securityBot here.

>securityBot, take dagger
The securityBot looks pissed. Maybe you outta not mess with securityBots...

>inv
You're carrying a message receiver, a coin, and a dagger. You're wearing ElectroMisdirector.

>securityBot, take coin
The securityBot looks pissed. Maybe you outta not mess with securityBots...

* * *

>security bot, hello
There is no reply.

>bartender, hello
There is no reply.

* * *

>sit chair
I didn't understand that sentence.

* * *

>get up
You'd rather be asleep.

"What a lovely soft and dreamy world", you think. Nothing is wrong and everything is right. Right and soft. Sooooo sooooofffft.

>stand
You'd rather be asleep.

"What a lovely soft and dreamy world", you think. Nothing is wrong and everything is right. Right and soft. Sooooo sooooofffft.

>stand
You'd rather be asleep.

"What a lovely soft and dreamy world", you think. Nothing is wrong and everything is right. Right and soft. Sooooo sooooofffft.

>get up
You'd rather be asleep.

"What a lovely soft and dreamy world", you think. Nothing is wrong and everything is right. Right and soft. Sooooo sooooofffft.

>get up from chair
You just can't get up, you are way too comfortable!

"What a lovely soft and dreamy world", you think. Nothing is wrong and everything is right. Right and soft. Sooooo sooooofffft.

* * *

>get up from chair
You just can't get up, you are way too comfortable!

"What a lovely soft and dreamy world", you think. Nothing is wrong and everything is right. Right and soft. Sooooo sooooofffft.

* * *

>get up from chair
Whew! You just barely escaped that chair, it's so comfy you could get stuck in it forever!

>sit chair
I didn't understand that sentence.

>sit on chair
Oh boy this chair looks really soft and comfy! Ooooh ya you are totally gonna sit on this chair big time.

"Hey Wait!" your subconscious jumps forth remembering the tempting softness - you decide not not to sit on that chair, it's so comfy you might never get up again!

>stand up
But you aren't in anything at the moment.

>sit on chair
Oh boy this chair looks really soft and comfy! Ooooh ya you are totally gonna sit on this chair big time.

"Hey Wait!" your subconscious jumps forth remembering the tempting softness - you decide not not to sit on that chair, it's so comfy you might never get up again!

>look chair
Watch out for that chair, it's so comfy you could get stuck in it forever!

>w
You can't go that way.

>look
Space Lounge
You are in the Space Lounge, rumored to be the center of The Resistance. "Why did I come here?" you briefly wonder before looking around.

You can see an airlock, a bar (on which are a glittery box (closed) and a Glowing Sphere), a chair, a bench, and a bartender here.

You can go east through the airlock (closed) from here.

(From here, you can move to east.)

* * *

>up
You don't have wings or pyscho-kinetic levitation abilities or a hoverboard or anything to go up with.

>down
Under the Veranda Walkway
Under the Veranda Walkway

You can go north, northeast, southeast, east, west, and up to the Veranda Walkway from here.

(From here, you can move to north, northeast, southeast, east, west, and up.)

>up
Veranda Walkway
Outside the Space Lounge you look out into the larger Raditree Building to see the pool with under a high ceiling. Consuite lies beyond the pool in the main courtyard. Boffers beat each other up in the fenced in section of the courtyard. A floating dolphin surveillance pod floats by making you twitch instintively to make your shiny wig come between the camera and your face.

You can see an airlock, a black rod, and a floating dolphin (closed) here.

You can go north, northeast, northwest, southeast, west through the airlock to the Space Lounge, up, and down to Under the Veranda Walkway from here.

(From here, you can move to north, northeast, northwest, southeast, west, up, and down.)

>se
Upper Southside Hallway
This hallway is NUTS - there are signs everywhere and lights and sounds flashing. From this hallway you can get into a bunch of Party Rooms

You can go north, northeast, and northwest to the Veranda Walkway from here.

(From here, you can move to north, northeast, and northwest.)

>n
Room 233
Room 233

You can go south to the Upper Southside Hallway from here.

(From here, you can move to south.)

>s
Upper Southside Hallway
This hallway is NUTS - there are signs everywhere and lights and sounds flashing. From this hallway you can get into a bunch of Party Rooms

You can go north to Room 233, northeast, and northwest to the Veranda Walkway from here.

(From here, you can move to north, northeast, and northwest.)

>nw
Veranda Walkway
Outside the Space Lounge you look out into the larger Raditree Building to see the pool with under a high ceiling. Consuite lies beyond the pool in the main courtyard. Boffers beat each other up in the fenced in section of the courtyard. A floating dolphin surveillance pod floats by making you twitch instintively to make your shiny wig come between the camera and your face.

You can see an airlock, a black rod, and a floating dolphin (closed) here.

You can go north, northeast, northwest, southeast to the Upper Southside Hallway, west through the airlock to the Space Lounge, up, and down to Under the Veranda Walkway from here.

(From here, you can move to north, northeast, northwest, southeast, west, up, and down.)

>se
Upper Southside Hallway
This hallway is NUTS - there are signs everywhere and lights and sounds flashing. From this hallway you can get into a bunch of Party Rooms

You can go north to Room 233, northeast, and northwest to the Veranda Walkway from here.

(From here, you can move to north, northeast, and northwest.)

>ne
Consuite
You can go northwest, southwest to the Upper Southside Hallway, and down from here.

(From here, you can move to northwest, southwest, and down.)

>sw
Upper Southside Hallway
This hallway is NUTS - there are signs everywhere and lights and sounds flashing. From this hallway you can get into a bunch of Party Rooms

You can go north to Room 233, northeast to Consuite, and northwest to the Veranda Walkway from here.

(From here, you can move to north, northeast, and northwest.)

* * *

>stand up chair
You just can't get up, you are way too comfortable! Maybe if you just stayed here in this chair forever you would be better off than whatever else you were going to do. Does it really matter?

"What a lovely soft and dreamy world", you think. Nothing is wrong and everything is right. Right and soft. Sooooo sooooofffft.

>stand up chair
You try to heave yourself up, but the soft lusciousness of the chair envelopes you and pulls you back into its comfy folds. Oooooo...so comfy...so sooooooofffffft...

"What a lovely soft and dreamy world", you think. Nothing is wrong and everything is right. Right and soft. Sooooo sooooofffft.

>stand up chair
Whew! You just barely escaped that chair, it's so comfy you could get stuck in it forever!

* * *

>sit on chair
Oh boy this chair looks really soft and comfy! Ooooh ya you are totally gonna sit on this chair big time.

You sit down and are so comfortable - you could really get used to being in this chair. Really! Wowsers...it's just the comfiest thing you probably ever plopped yer can on...it's like you're almost part of this thing...like your skin is melding with it and your insides are turning to some sort of tiny little beans...or a kind of foam batting material...

"What a lovely soft and dreamy world", you think. Nothing is wrong and everything is right. Right and soft. Sooooo sooooofffft.

>get off chair
You just can't get up, you are way too comfortable! Maybe if you just stayed here in this chair forever you would be better off than whatever else you were going to do. Does it really matter?

"What a lovely soft and dreamy world", you think. Nothing is wrong and everything is right. Right and soft. Sooooo sooooofffft.

>get off chair
You try to heave yourself up, but the soft lusciousness of the chair envelopes you and pulls you back into its comfy folds.

"What a lovely soft and dreamy world", you think. Nothing is wrong and everything is right. Right and soft. Sooooo sooooofffft.

>get off chair
"What a lovely soft and dreamy world", you think. Nothing is wrong and everything is right. Right and soft. Sooooo sooooofffft.

>get off chair
Whew! You just barely escaped that chair, it's so comfy you could get stuck in it forever!

>look
Space Lounge
You are in the Space Lounge, rumored to be the center of The Resistance. "Why did I come here?" you briefly wonder before looking around.

You can see an airlock, a bar (on which are a glittery box (closed) and a Glowing Sphere), a chair, a bench and a bartender here.

* * *

>get off chair
You just can't get up, you are way too comfortable! Maybe if you just stayed here in this chair forever you would be better off than whatever else you were going to do. Does it really matter?

"What a lovely soft and dreamy world", you think. Nothing is wrong and everything is right. Right and soft. Sooooo sooooofffft.

>stand up
You'd rather be asleep. Whatever other thing you would do besides being in this chair is a bad idea and not really that good of an option compared to being in this insanely comfy chair.

"What a lovely soft and dreamy world", you think. Nothing is wrong and everything is right. Right and soft. Sooooo sooooofffft.

>get up from chair
You try to heave yourself up, but the soft lusciousness of the chair envelopes you and pulls you back into its comfy folds. Oooooo...so comfy...so sooooooofffffft...

"What a lovely soft and dreamy world", you think. Nothing is wrong and everything is right. Right and soft. Sooooo sooooofffft.

>get up from chair
Whew! You just barely escaped that chair, it's so comfy you could get stuck in it forever!

* * *

>get up from chair
You just can't get up, you are way too comfortable! Maybe if you just stayed here in this chair forever you would be better off than whatever else you were going to do. Does it really matter?

"What a lovely soft and dreamy world", you think. Nothing is wrong and everything is right. Right and soft. Sooooo sooooofffft.

>get up crom chair
I only understood you as far as wanting to get up.

>get up from chair
You try to heave yourself up, but the soft lusciousness of the chair envelopes you and pulls you back into its comfy folds. Oooooo...so comfy...so sooooooofffffft...

"What a lovely soft and dreamy world", you think. Nothing is wrong and everything is right. Right and soft. Sooooo sooooofffft.

* * *

>get up from chair
Whew! You just barely escaped that chair, it's so comfy you could get stuck in it forever!

>sit on chair
Oh boy this chair looks really soft and comfy! Ooooh ya you are totally gonna sit on this chair big time.

Don't you remember the last time you were in that chair? It almost ATE YOU! What is your deal? Don't sit in this chair, it's too dangerous! You'd have to be like, a master of mental projection to sit on this chair without it's super soft comfy-ness obliterate you and subsume your soul.

* * *

>sit chair
I didn't understand that sentence.

>sit on chair
Oh boy this chair looks really soft and comfy! Ooooh ya you are totally gonna sit on this chair big time.

"Hey Wait!" your subconscious jumps forth remembering the tempting softness - you decide not not to sit on that chair, it's so comfy you might never get up again! It looks seriously comfy though...maybe just for a little tiny sliver of a moment you could get kinda comfy...

>sit on chair
Oh boy this chair looks really soft and comfy! Ooooh ya you are totally gonna sit on this chair big time.

"Hey Wait!" your subconscious jumps forth remembering the tempting softness - you decide not not to sit on that chair, it's so comfy you might never get up again! It looks seriously comfy though...maybe just for a little tiny sliver of a moment you could get kinda comfy...

* * *

>get up from chair
Whew! You just barely escaped that chair, it's so comfy you could get stuck in it forever!

>sit on chair
Oh boy this chair looks really soft and comfy! Ooooh ya you are totally gonna sit on this chair big time.

"Hey Wait!" your subconscious jumps forth remembering the tempting softness - you decide not not to sit on that chair, it's so comfy you might never get up again! It looks seriously comfy though...maybe just for a little tiny sliver of a moment you could get kinda comfy...

>sit on chair
Oh boy this chair looks really soft and comfy! Ooooh ya you are totally gonna sit on this chair big time.

Don't you remember the last time you were in that chair? It almost ATE YOU! What is your deal? Don't sit in this chair, it's too dangerous! You'd have to be like, a master of mental projection to sit on this chair without it's super soft comfy-ness obliterate you and subsume your soul.

* * *

>look
Space Lounge (on the chair)
You are in the Space Lounge, rumored to be the center of The Resistance. "Why did I come here?" you briefly wonder before looking around.

You can see an airlock, a bar (on which are a glittery box (closed) and a Glowing Sphere), a bench, a bartender, and a black ninja costume here.

You can go east through the airlock (closed) from here.

(From here, you can move to east.)

"What a lovely soft and dreamy world", you think. Nothing is wrong and everything is right. Right and soft. Sooooo sooooofffft.

>e
(first opening the airlock)
(first unlocking the airlock)
You'd rather be asleep. Whatever other thing you would do besides being in this chair is a bad idea and not really that good of an option compared to being in this insanely comfy chair.

"What a lovely soft and dreamy world", you think. Nothing is wrong and everything is right. Right and soft. Sooooo sooooofffft.

>e
(first opening the airlock)
(first unlocking the airlock)
You'd rather be asleep. Whatever other thing you would do besides being in this chair is a bad idea and not really that good of an option compared to being in this insanely comfy chair.

"What a lovely soft and dreamy world", you think. Nothing is wrong and everything is right. Right and soft. Sooooo sooooofffft.

* * *

>get up from chair
You just can't get up, you are way too comfortable! Maybe if you just stayed here in this chair forever you would be better off than whatever else you were going to do. Does it really matter?

"What a lovely soft and dreamy world", you think. Nothing is wrong and everything is right. Right and soft. Sooooo sooooofffft.

>look
Space Lounge (on the chair)
You are in the Space Lounge, rumored to be the center of The Resistance. "Why did I come here?" you briefly wonder before looking around.

You can see an airlock, a bar (on which are a glittery box (closed) and a Glowing Sphere), a bench, a bartender, and a black ninja costume here.

You can go east through the airlock (closed) from here.

(From here, you can move to east.)

"What a lovely soft and dreamy world", you think. Nothing is wrong and everything is right. Right and soft. Sooooo sooooofffft.

>look
Space Lounge (on the chair)
You are in the Space Lounge, rumored to be the center of The Resistance. "Why did I come here?" you briefly wonder before looking around.

You can see an airlock, a bar (on which are a glittery box (closed) and a Glowing Sphere), a bench, a bartender, and a black ninja costume here.

You can go east through the airlock (closed) from here.

(From here, you can move to east.)

"What a lovely soft and dreamy world", you think. Nothing is wrong and everything is right. Right and soft. Sooooo sooooofffft.

>get up from chair
You try to heave yourself up, but the soft lusciousness of the chair envelopes you and pulls you back into its comfy folds. Oooooo...so comfy...so sooooooofffffft...

"What a lovely soft and dreamy world", you think. Nothing is wrong and everything is right. Right and soft. Sooooo sooooofffft.

* * *

>sit on chair
Oh boy this chair looks really soft and comfy! Ooooh ya you are totally gonna sit on this chair big time.

"Hey Wait!" your subconscious jumps forth remembering the tempting softness - you decide not not to sit on that chair, it's so comfy you might never get up again! It looks seriously comfy though...maybe just for a little tiny sliver of a moment you could get kinda comfy...

>sit on chair
Oh boy this chair looks really soft and comfy! Ooooh ya you are totally gonna sit on this chair big time.

Don't you remember the last time you were in that chair? It almost ATE YOU! What is your deal? Don't sit in this chair, it's too dangerous! Only a master of mental projection could sit on this chair without its super soft comfy-ness obliterating and subsuming your soul to its dark desires (whatever they might be).

* * *

>look
Space Lounge (on the chair)
You are in the Space Lounge, rumored to be the center of The Resistance. "Why did I come here?" you briefly wonder before looking around.

You can see an airlock, a bar (on which are a glittery box (closed) and a Glowing Sphere), a bench, a bartender, and a black ninja costume here.

You can go east through the airlock (closed) from here.

(From here, you can move to east.)

"What a lovely soft and dreamy world", you think. Nothing is wrong and everything is right. Right and soft. Sooooo sooooofffft.

>open box
You'd rather be asleep. Besides glittery box is really far away, and you're so comfortable you don't really feel like moving.

"What a lovely soft and dreamy world", you think. Nothing is wrong and everything is right. Right and soft. Sooooo sooooofffft.

* * *

>open box
You'd rather be asleep.

"What a lovely soft and dreamy world", you think. Nothing is wrong and everything is right. Right and soft. Sooooo sooooofffft.

>look box
You'd rather be asleep.

"What a lovely soft and dreamy world", you think. Nothing is wrong and everything is right. Right and soft. Sooooo sooooofffft.

>get off chair
You just can't get up, you are way too comfortable!

"What a lovely soft and dreamy world", you think. Nothing is wrong and everything is right. Right and soft. Sooooo sooooofffft.

>get off chair
You try to heave yourself up, but the soft lusciousness of the chair envelopes you and pulls you back into its comfy folds.

"What a lovely soft and dreamy world", you think. Nothing is wrong and everything is right. Right and soft. Sooooo sooooofffft.

* * *

>get off chair
Whew! You just barely escaped that chair, it's so comfy you could get stuck in it forever!

>get off chair
You'd rather be asleep.

"What a lovely soft and dreamy world", you think. Nothing is wrong and everything is right. Right and soft. Sooooo sooooofffft.

>get off chair
You'd rather be asleep.

"What a lovely soft and dreamy world", you think. Nothing is wrong and everything is right. Right and soft. Sooooo sooooofffft.

* * *

>get off chair
Whew! You just barely escaped that chair, it's so comfy you could get stuck in it forever!

>open box
You open the glittery box, revealing a security readout, a bowl and a crazy looking gun.

>sit on chair
Oh boy this chair looks really soft and comfy! Ooooh ya you are totally gonna sit on that chair.

You decide not not to sit on that chair, it's so comfy you might never get up again!

>look
Space Lounge
You are in the Space Lounge, rumored to be the center of The Resistance. "Why did I come here?" you briefly wonder before looking around.

You can see an airlock, a bar (on which are a glittery box (in which are a security readout, a bowl (in which is a note) and a crazy looking gun) and a Glowing Sphere), a chair, a bench and a bartender here.

* * *

>sit on chair
Oh boy this chair looks really soft and comfy! Ooooh ya you are totally gonna sit on that chair.

You decide not not to sit on that chair, it's so comfy you might never get up again!

"What a lovely soft and dreamy world", you think. Nothing is wrong and everything is right. Right and soft. Sooooo sooooofffft.

>sit on bench
You are already sitting on bench.

"What a lovely soft and dreamy world", you think. Nothing is wrong and everything is right. Right and soft. Sooooo sooooofffft.

>get off chair
You just can't get up, you are way too comfortable!

"What a lovely soft and dreamy world", you think. Nothing is wrong and everything is right. Right and soft. Sooooo sooooofffft.

* * *

>get off chair
Whew! You just barely escaped that chair, it's so comfy you could get stuck in it forever!

>sit on bench
You get onto the bench.

>sit on chair
Oh boy this chair looks really soft and comfy! Ooooh ya you are totally gonna sit on that chair.

You decide not not to sit on that chair, it's so comfy you might never get up again!

>sit on chair
Oh boy this chair looks really soft and comfy! Ooooh ya you are totally gonna sit on that chair.

You decide not not to sit on that chair, it's so comfy you might never get up again!

* * *

>stand up
You'd rather be asleep. Whatever other thing you would do besides being in this chair is a bad idea and not really that good of an option compared to being in this insanely comfy chair.

"What a lovely soft and dreamy world", you think. Nothing is wrong and everything is right. Right and soft. Sooooo sooooofffft.

* * *

>spacebug
spacebug? Interesting, nice.

Space Lounge
You are in the Space Lounge. It's dim and glowy all over with pulsating colors and subtle hypnotic sounds.

You can see an airlock, a black ninja outfit, a bar (on which are a Glowing Sphere and a glittery box (closed)), a bench, a comfy looking chair, a bartender, AFrame, and a securityBot here.

>look chair
The comfy looking chair is kind of an average looking comfy looking chair.

>sit chair
I didn't understand that sentence.

>use chair
I didn't understand that sentence.

>sit on chair
Oh boy this chair looks really soft and comfy! Ooooh ya you are totally gonna sit on this chair big time.

You get onto the comfy looking chair.

Sooooo comfy. So sooooo comfy. Mmmmm...

>pet chair
I didn't understand that sentence.

>recline chair
I didn't understand that sentence.

>look
Space Lounge (on the comfy looking chair)
You are in the Space Lounge. It's dim and glowy all over with pulsating colors and subtle hypnotic sounds.

You can see an airlock, a black ninja outfit, a bar (on which are a Glowing Sphere and a glittery box (closed)), a bench, a bartender, AFrame, and a securityBot here.

Sooooo comfy. So sooooo comfy. Mmmmm...

>get chair
You'd rather be asleep. Whatever other thing you would do besides being in this chair is a bad idea and not really that good of an option compared to being in this insanely comfy chair.

"What was I trying to do?" you think for a sec before you realize how comfy the chair you are in is. It's kind of incredible, you feel like you've accomlished enough in life.

>leave chair
I only understood you as far as wanting to leave.

>get off chair
You just can't get up, you are way too comfortable! Maybe if you just stayed here in this comfy looking chair forever you would be better off than whatever else you were going to do. Does it really matter?

Sooooo comfy. So sooooo comfy. Mmmmm...

>get off chair
You try to heave yourself up, but the soft lusciousness of the comfy looking chair envelopes you and pulls you back into its comfy folds. Oooooo...so comfy...so sooooooofffffft...

Sooooo comfy. So sooooo comfy. Mmmmm...

* * *

>get off chair
Whew! You just barely escaped that comfy looking chair, it's so comfy you could get stuck in it forever!

>look chair
Watch out for that comfy looking chair, it's so comfy you could get stuck in it forever! Like LITERALLY foreverandever.

>sit on chair
Oh boy this chair looks really soft and comfy! Ooooh ya you are totally gonna sit on this chair big time.

"Hey Wait!" your subconscious jumps forth remembering the tempting softness - you decide not not to sit on that comfy looking chair, it's so comfy you might never get up again! It looks seriously comfy though...maybe just for a little tiny sliver of a moment you could get kinda comfy...

>get off chair
But you aren't on the comfy looking chair at the moment.

* * *

>sit on chair
Oh boy this chair looks really soft and comfy! Ooooh ya you are totally gonna sit on this chair big time.

Don't you remember the last time you were in that comfy looking chair? It almost ATE YOU! What is your deal? Don't sit in this comfy looking chair, it's too dangerous! Only a master of mental projection could sit on this comfy looking chair without its super soft comfy-ness obliterating and subsuming your soul to its dark comfy desires.

>sit on chair
Oh boy this chair looks really soft and comfy! Ooooh ya you are totally gonna sit on this chair big time.

    *** You sit on the chair again and sink forever into its comfyness. You never rise again. ***

In that game you scored 0 out of a possible 0, in 12 turns.

Would you like to RESTART, RESTORE a saved game, QUIT, or UNDO the last command?

>restart
In the early 2000s, mewonkind's folly led to the breakdown of society and the restructuring of general cultural and technological vector-goals. At some point interest-tribes formed into coherent anarcho-syndicates, creating new economic models which began to isolate themselves in order to maximize survival attributes and minimize unknown variable influences. It was around that time the blast doors went down. Nobody's sure how long exactly; it's been hundreds of season renewals and a ton of spin-offs and crossovers since then though. At least that's what you were taught in data-download segment 2-histori-political info part 27A while syncing the standard edu-packets. Who the hell knows for real though, right?

Whatevs. Feels like just another day in the MASSIVE HIVE KNOWN as CONvergence.

You have more than a couple enemies.

Today's magic number is 309.

What is your name?

>spacebug
spacebug!? Har har har! Musta been one-a them vat babies huh?

Space Lounge
You are in the Space Lounge. It's dim and glowy all over with pulsating colors and subtle hypnotic sounds.

You can see an airlock, a black ninja outfit, a bar (on which are a Glowing Sphere and a glittery box (closed)), a bench, a comfy looking chair, a bartender, AFrame, and a securityBot here.

>open glittery box
You open the glittery box, revealing a securityReadout, a bowl, and a crazy looking gun.

>look securityReadout
The screen is blank.

The securityReadout is currently switched off.

>turn securityReadout on
You switch the securityReadout on.

>read securityReadout
The screen reads: 

 airlock (Space Lounge/Veranda Walkway): UNLOCKED

>open airlock
You open the airlock.

>take glittery box
OOOHhhhhhh! You get a funny tingle when you try to pick the box up, the sides are so slippery it almost feels COMPLETELY FRICTIONLESS. You can't seem to grab it all, it's really weird.

>look black ninja outfit
This is a ninja outfit, it's black and has a hood that covers your face. It has a nice pocket in it to store cool ninja gear. It has these sweet built in booties that muffle your footsteps as if you were a total ninja, which you totally are if you are wearing this outfit. You could sneak around a place with shadows without being detected if you were wearing this thing. You'd be so ninja.

The black ninja outfit's pocket contains a throwing star and a smoke bomb.

>wear ninja outfit
(first taking the black ninja outfit)
You are a ninja! It feels like you could blend into the shadows, or maybe you ARE the shadows, this ninja outfit makes you feel super ninja-like

>look
Space Lounge
You are in the Space Lounge. It's dim and glowy all over with pulsating colors and subtle hypnotic sounds.

You can see an airlock, a bar (on which are a Glowing Sphere and a glittery box (in which are a securityReadout, a bowl (in which is a note), and a crazy looking gun)), a bench, a comfy looking chair, a bartender, AFrame, and a securityBot here.

>look at myself
As good-looking as ever.

>look gun
That gun is so crazy looking! It's kind of like totally blowing your mind.

* * *

>take gun
You have no idea what this gun does. You've never seen anything like it! You're pretty stoked to get this gun.

Taken.

>fire gun
What do you want to fire the crazy looking gun at?

>fire gun at comfy chair
ZAP! The comfy looking chair twinkles out of existence!

>talk securityBot
I didn't understand that sentence.

* * *

>talk to securityBot
You say hello to the securityBot.

>look Glowing Sphere
OOOOoooo glowy-sphere thingie! Its purple soft glow makes you feel safe and secure. It looks like there's some sort of encased helix-key as a component to the glowy-ness.

>take helix key
You can't see any such thing.

>look helix
You can't see any such thing.

>take sphere
That's fixed in place.

>touch sphere
You feel nothing unexpected.

>look
Space Lounge
You are in the Space Lounge. It's dim and glowy all over with pulsating colors and subtle hypnotic sounds.

You can see an airlock, a bar (on which are a Glowing Sphere and a glittery box (in which are a securityReadout and a bowl (in which is a note))), a bench, a bartender, AFrame, and a securityBot here.

>go through airlock
As you enter the Veranda Walkway you see a floating dolphin surveillance pod.
Sweet it seems like your ElectroMisdirector shielded you from detection. 

Veranda Walkway
Outside the Space Lounge you look out into the larger Raditree Building to see the pool under a high ceiling. Consuite lies beyond the pool in the main courtyard. Boffers beat each other up in the fenced in section of the courtyard. There's a floating platform above the pool.

You can see an airlock, a black rod, and a floating dolphin (closed) here.

>look black rod
A three foot black rod with a rusty star on one end lies nearby.

>take black rod
Taken.

>use black rod
I didn't understand that sentence.

>swing rod
There's nothing sensible to swing here.

>open dolphin
(first unlocking the floating dolphin)
You lack a key that fits the floating dolphin.

>go lounge
You can't see any such thing.

>e
You can't go that way.

>w
Space Lounge
You are in the Space Lounge. It's dim and glowy all over with pulsating colors and subtle hypnotic sounds.

You can see an airlock, a bar (on which are a Glowing Sphere and a glittery box (in which are a securityReadout and a bowl (in which is a note))), a bench, a bartender, AFrame, and a securityBot here.

>shoot sphere
(with the crazy looking gun)
ZAP! The Glowing Sphere twinkles out of existence! The securityKey clatters to the ground!

>take key
You can't see any such thing.

>use securityKey
I didn't understand that sentence.

>take securityKey
Taken.

>e
As you enter the Veranda Walkway you see a floating dolphin surveillance pod.
Sweet it seems like your ElectroMisdirector shielded you from detection. 

Veranda Walkway
Outside the Space Lounge you look out into the larger Raditree Building to see the pool under a high ceiling. Consuite lies beyond the pool in the main courtyard. Boffers beat each other up in the fenced in section of the courtyard. There's a floating platform above the pool.

You can see an airlock and a floating dolphin (closed) here.

>use securityKey
I didn't understand that sentence.

>open dolphin
(first unlocking the floating dolphin)
You lack a key that fits the floating dolphin.

>haaay
I didn't understand that sentence.

>w
Space Lounge
You are in the Space Lounge. It's dim and glowy all over with pulsating colors and subtle hypnotic sounds.

You can see an airlock, a bar (on which is a glittery box (in which are a securityReadout and a bowl (in which is a note))), a bench, a bartender, AFrame, and a securityBot here.

>look bowl
The bowl is kind of an average looking bowl.

In the bowl is a note.

>read note
Cast the secret spell xyzzy

>cast spell
I didn't understand that sentence.

>cast secret spell
I didn't understand that sentence.

>xyzzy
you feel a whooshy sound enter your eyeball sockets and then your tummy flips over your groiny-place. WHOOOOOAAAA suddenly you find yourself trasported to the...

you feel a whooshy sound enter your eyeball sockets and then your tummy flips over your groiny-place. WHOOOOOAAAA suddenly you find yourself trasported to the...

Secret Room
You are in the Secret Room. DON'T TELL ANYONE YOU WERE EVER HERE! It's really dark, you can't see much.

You can see a dolphin code and a book here.

Under the influence of the black rod, you pronounced "xyzzy" as Xhi-zee. You understand now that the purpose of the black rod is to bring people here, to the Secret Room.

>look dolphin code
It is fish shaped, and vibrates - readout screen says "Status optimal".

>take dolphin code
Taken.

>w
You can't go that way.

>e
You can't go that way.

>n
You can't go that way.

>look
Secret Room
You are in the Secret Room. DON'T TELL ANYONE YOU WERE EVER HERE! It's really dark, you can't see much.

You can see a book here.

>read book
"yzxxy" is the title, and the contents just say "Your Future Lies in Space" over and over again.

>take book
Taken.

>leave secret room
I only understood you as far as wanting to leave.

>n
You can't go that way.

>s
You can't go that way.

>e
You can't go that way.

>w
You can't go that way.

>your future liesin space
I didn't understand that sentence.

>yzxxy
Space Lounge
You are in the Space Lounge. It's dim and glowy all over with pulsating colors and subtle hypnotic sounds.

You can see an airlock, a bar (on which is a glittery box (in which are a securityReadout and a bowl (in which is a note))), a bench, a bartender, AFrame, and a securityBot here.

Under the influence of the black rod, you pronounced "yzxxy" as Wizex-zi. You are glad there is some way out of that Secret Room!

>w
BehindtheBar
You shouldn't be here, it's behind the bar.

You can see shinyUnicorn, rocketBlaster, anther, and thisas here.

>look shinyUnicorn
This thing is like taking a bath in frozen unicorn snot. Amazing.

>look rocketBlaster
Neon Yellow. Glows and bubbles. It's gonna shoot you into SPACE!

>take rocketBlaster
Taken.

>use rocketBlaster
I didn't understand that sentence.

>fire rocketBlaster
You can't see any such thing.

>shoot rocketBlaster
(with the crazy looking gun)
ZAP! RocketBlaster twinkles out of existence!

>drink rocketBlaster
You can't see any such thing.

>drink shinyUnicorn
You quaff shinyUnicorn. It goes down beautifully.

Floating Courtyard
This is amazing - you are up above everything and can see so much up here! There's a pool down below, and a fenced in courtyard with some kind of securityGate system surrounding it, and Consuite.

>open dolphin
It isn't something you can open.

>look
Floating Courtyard
This is amazing - you are up above everything and can see so much up here! There's a pool down below, and a fenced in courtyard with some kind of securityGate system surrounding it, and Consuite.

>down
As you enter the Veranda Walkway you see a floating dolphin surveillance pod.
Sweet it seems like your ElectroMisdirector shielded you from detection. 

Veranda Walkway
Outside the Space Lounge you look out into the larger Raditree Building to see the pool under a high ceiling. Consuite lies beyond the pool in the main courtyard. Boffers beat each other up in the fenced in section of the courtyard. There's a floating platform above the pool.

You can see an airlock and a floating dolphin (closed) here.

>up
You don't have wings or pyscho-kinetic levitation abilities or a hoverboard or anything to go up with.

>open dolphin
(the dolphin code)
It isn't something you can open.

>xyzzy
you feel a whooshy sound enter your eyeball sockets and then your tummy flips over your groiny-place. WHOOOOOAAAA suddenly you find yourself trasported to the...

you feel a whooshy sound enter your eyeball sockets and then your tummy flips over your groiny-place. WHOOOOOAAAA suddenly you find yourself trasported to the...

Secret Room
You are in the Secret Room. DON'T TELL ANYONE YOU WERE EVER HERE! It's really dark, you can't see much.

Under the influence of the black rod, you pronounced "xyzzy" as Xhi-zee. You understand now that the purpose of the black rod is to bring people here, to the Secret Room.

>inventory
You're carrying a book, a dolphin code, a securityKey, a black rod, a crazy looking gun, a message receiver, a coin, and a dagger. You're wearing a black ninja outfit and ElectroMisdirector.

>w
You can't go that way.

>yzxxy
Space Lounge
You are in the Space Lounge. It's dim and glowy all over with pulsating colors and subtle hypnotic sounds.

You can see an airlock, a bar (on which is a glittery box (in which are a securityReadout and a bowl (in which is a note))), a bench, a bartender, AFrame, and a securityBot here.

Under the influence of the black rod, you pronounced "yzxxy" as Wizex-zi. You are glad there is some way out of that Secret Room!

>e
As you enter the Veranda Walkway you see a floating dolphin surveillance pod.
Sweet it seems like your ElectroMisdirector shielded you from detection. 

Veranda Walkway
Outside the Space Lounge you look out into the larger Raditree Building to see the pool under a high ceiling. Consuite lies beyond the pool in the main courtyard. Boffers beat each other up in the fenced in section of the courtyard. There's a floating platform above the pool.

You can see an airlock and a floating dolphin (closed) here.

>open dolphin
(the dolphin code)
It isn't something you can open.

>get inside dolphin
I only understood you as far as wanting to get inside.

>unlock dolphin
(with the dolphin code)
You unlock the floating dolphin.

>get inside dolphin
I only understood you as far as wanting to get inside.

>drive dolphin
I didn't understand that sentence.

>use dolphin
I didn't understand that sentence.

>dolphin dolphin
I didn't understand that sentence.

>get in dolphin
(the dolphin code)
That's not something you can enter.

>enter dolphin
(the dolphin code)
That's not something you can enter.

>w
Space Lounge
You are in the Space Lounge. It's dim and glowy all over with pulsating colors and subtle hypnotic sounds.

You can see an airlock, a bar (on which is a glittery box (in which are a securityReadout and a bowl (in which is a note))), a bench, a bartender, AFrame, and a securityBot here.

>e
As you enter the Veranda Walkway you see a floating dolphin surveillance pod.
Sweet it seems like your ElectroMisdirector shielded you from detection. 

Veranda Walkway
Outside the Space Lounge you look out into the larger Raditree Building to see the pool under a high ceiling. Consuite lies beyond the pool in the main courtyard. Boffers beat each other up in the fenced in section of the courtyard. There's a floating platform above the pool.

You can see an airlock and a floating dolphin (closed) here.

>e
You can't go that way.

>s
You can't go that way.

>n
Floor Changer
Elevators, escalators, and stairwell.

>use elevator
I didn't understand that sentence.

>use stairwell
I didn't understand that sentence.

>up stairwell
I only understood you as far as wanting to (go) up.

>up
You can't go that way.

>down
Lower Floor Changer
Lower elevators, escalators and stairwell lower level

>w
Front Desk
The Front Desk

>look front desk
You can't see any such thing.

* * *

>stab boffer
What do you want to stab the boffer with?

>stab boffer with dagger
You stab the boffer with your the dagger. The boffer yells out in pain.  (The boffer's health: 90)

>stab boffer with dagger
You stab the boffer with your the dagger. The boffer yells out in pain.  (The boffer's health: 87)

>stab boffer with dagger
You stab the boffer with your the dagger. The boffer yells out in pain.  (The boffer's health: 82)

>stab boffer with dagger
You stab the boffer with your the dagger. The boffer yells out in pain.  (The boffer's health: 72)

>look boffer
Standard boffer looking bloke, wearing simple leather armor and wielding a staff and smiling at you menacingly.

(Health: 72)

>boffer i
I didn't understand that sentence.

* * *

>stab boffer with dagger
You stab the boffer with your the dagger. The boffer yells out in pain.  (The boffer's health: 90)

The boffer stabs you! (Health: 92)

>stab boffer with dagger
You stab the boffer with your the dagger. The boffer yells out in pain.  (The boffer's health: 80)

The boffer stabs you! (Health: 83)

>stab boffer with dagger
You stab the boffer with your the dagger. The boffer yells out in pain.  (The boffer's health: 71)

The boffer stabs you! (Health: 76)

>stab boffer with dagger
You stab the boffer with your the dagger. The boffer yells out in pain.  (The boffer's health: 65)

The boffer stabs you! (Health: 67)

>stab boffer with dagger
You stab the boffer with your the dagger. The boffer yells out in pain.  (The boffer's health: 61)

The boffer stabs you! (Health: 60)

>stab boffer with dagger
You stab the boffer with your the dagger. The boffer yells out in pain.  (The boffer's health: 57)

The boffer stabs you! (Health: 50)

>stab boffer with dagger
You stab the boffer with your the dagger. The boffer yells out in pain.  (The boffer's health: 53)

The boffer stabs you! (Health: 43)

>stab boffer with dagger
You stab the boffer with your the dagger. The boffer yells out in pain.  (The boffer's health: 45)

The boffer stabs you! (Health: 34)

>stab boffer with dagger
You stab the boffer with your the dagger. The boffer yells out in pain.  (The boffer's health: 38)

The boffer stabs you! (Health: 24)

>stab boffer with dagger
You stab the boffer with your the dagger. The boffer yells out in pain.  (The boffer's health: 33)

The boffer stabs you! (Health: 17)

>stab boffer with dagger
You stab the boffer with your the dagger. The boffer yells out in pain.  (The boffer's health: 23)

The boffer stabs you! (Health: 8)

>stab boffer with dagger
You stab the boffer with your the dagger. The boffer yells out in pain.  (The boffer's health: 15)

The boffer stabs you! (Health: 1)

>stab boffer with dagger
You stab the boffer with your the dagger. The boffer yells out in pain.  (The boffer's health: 9)

The boffer stabs you with the nanocarbon blade, and you drop to the ground, dead.

    *** You have died. ***

In that game you scored 0 out of a possible 0, in 13 turns.

Would you like to RESTART, RESTORE a saved game, QUIT, or UNDO the last command?

>restart
In the early 2000"s, mewonkind's folly led to the breakdown of society and the restructuring of general cultural and technological vector-goals. At least that's what you were taught in data-download segment 2-histori-political info part 27A while syncing the standard edu-packets back in school. Now though, you find yourself inside of the massive hive known as CONvergence.

N is one.

Today's magic number is boring.

X is eleven!

Splounge-Dystopia
Watch your back, and don't let the cams spy your face. by Aaron Prust
Release 1 / Serial number 171213 / Inform 7 build 6M62 (I6/v6.33 lib 6/12N) SD

Garden Court
Garden Court

You can see a boffer here.

You can go west from here.

>stab boffer with dagger
You stab the boffer with your the dagger. The boffer yells out in pain.  (The boffer's health: 94)

The boffer stabs you! (Health: 92)

>e
You can't go that way.

The boffer stabs you! (Health: 85)

>w
Under the Veranda Walkway
You can go north, northeast, southeast, east to the Garden Court, west, and up from here.

(From here, you can move to north, northeast, southeast, east, west, and up.)

>e
Garden Court
Garden Court

You can see a boffer here.

You can go west to Under the Veranda Walkway from here.

(From here, you can move to west.)

The boffer stabs you! (Health: 77)

>w
Under the Veranda Walkway
You can go north, northeast, southeast, east to the Garden Court, west, and up from here.

(From here, you can move to north, northeast, southeast, east, west, and up.)

* * *

>starfive
starfive!? Har har har! Musta been one-a them vat babies huh?

Space Lounge
You are in the Space Lounge. It's dim and glowy all over with pulsating colors and subtle hypnotic sounds.

You can see an airlock, a black ninja outfit, a bar (on which are a Glowing Sphere and a glittery box (closed)), a bench, a chair, a bartender, AFrame, and a Security bot here.

You can go east through the airlock (closed) and west from here.

(From here, you can move to east and west.)

>take ninja outfit
Taken.

>put on ninja outfit
You are a ninja! It feels like you could blend into the shadows, or maybe you ARE the shadows, this ninja outfit makes you feel super ninja-like

>look at sphere
OOOOoooo glowy-sphere thingie! Its purple soft glow makes you feel safe and secure. It looks like there's some sort of helix-key as a component to the glowy-ness but it's unclear how you would remove it.

>talk to bartender
You say hello to the bartender.

>take sphere
That's fixed in place.

>open box
You open the glittery box, revealing a security readout, a bowl, and a crazy looking gun.

* * *

>take bowl
Taken.

>look bowl
The bowl is kind of unremarkable, not really exciting like some cool crazy gun would be or something.

In the bowl is a note.

* * *

>read note
Cast the secret spell xyzzy

>say xyzzy
You are unable to articulate the second "z" separately from the first, and the spell fails in a disdainful puff. If only you had some sort of magical item to focus your arcane arts upon to increase your attunement to the fey realm.

>look readout
The screen is blank.

The security readout is currently switched off.

>turn readout on
You switch the security readout on.

>look readout
The screen reads: 

 airlock (Space Lounge/Veranda Walkway): UNLOCKED

>look gun
That gun is so crazy looking! It's kind of like totally blowing your mind.

>look
Space Lounge
You are in the Space Lounge. It's dim and glowy all over with pulsating colors and subtle hypnotic sounds.

You can see an airlock, a bar (on which are a Glowing Sphere and a glittery box (in which is a security readout)), a bench, a chair, a bartender, AFrame, and a Security bot here.

You can go east through the airlock (closed) and west from here.

(From here, you can move to east and west.)

>look bench
Cool smooth bench.

* * *

>sit bench
I didn't understand that sentence.

>inventory
You are carrying: 
a bowl
a crazy looking gun
a black ninja outfit
ElectroMisdirector
a message receiver
a coin
a dagger
(Health: 100)

>look electromisdirctor
A small device shaped like a horseshoe worn as a hat that misdirects any light coming towards your face upward. Kinda makes it look like you have no head. Totally legal (as long as you have the licensure information correctly processed of course). (Which you don't.)

>l coin
The coin is kind of unremarkable, not really exciting like some cool crazy gun would be or something.

>l dagger
The dagger is kind of unremarkable, not really exciting like some cool crazy gun would be or something.

>l gun
That gun is so crazy looking! It's kind of like totally blowing your mind.

>shoot sphere
(with the crazy looking gun)
You need a projectile weapon to shoot anything.

>shoot sphere with gun
You need a projectile weapon to shoot anything.

>l
Space Lounge
You are in the Space Lounge. It's dim and glowy all over with pulsating colors and subtle hypnotic sounds.

You can see an airlock, a bar (on which are a Glowing Sphere and a glittery box (in which is a security readout)), a bench, a chair, a bartender, AFrame, and a Security bot here.

You can go east through the airlock (closed) and west from here.

(From here, you can move to east and west.)

>go e
(first opening the airlock)

Veranda Walkway
Outside the Space Lounge you look out into the larger Raditree Building to see the pool under a high ceiling. Consuite lies beyond the pool in the main courtyard. Boffers beat each other up in the fenced in section of the courtyard. A floating dolphin surveillance pod floats by making you twitch instintively to make your shiny wig come between the camera and your face.

You can see an airlock, a black rod, and a floating dolphin (closed) here.

You can go north, northeast, northwest, southeast, west through the airlock to the Space Lounge, up, and down from here.

(From here, you can move to north, northeast, northwest, southeast, west, up, and down.)

>n
Floor Changer
Elevators, escalators, and stairwell.

You can go northeast, northwest, south to the Veranda Walkway, east, west, and down from here.

(From here, you can move to northeast, northwest, south, east, west, and down.)

* * *

>w
Convergence Central
Convergence Central

You can go northeast, south, southwest, and east to the Floor Changer from here.

(From here, you can move to northeast, south, southwest, and east.)

>l
Convergence Central
Convergence Central

You can go northeast, south, southwest, and east to the Floor Changer from here.

(From here, you can move to northeast, south, southwest, and east.)

>sw
Dealer's Room
Dealer's Room

You can go northeast to Convergence Central from here.

(From here, you can move to northeast.)

>ne
Convergence Central
Convergence Central

You can go northeast, south, southwest to the Dealer's Room, and east to the Floor Changer from here.

(From here, you can move to northeast, south, southwest, and east.)

>e
Floor Changer
Elevators, escalators, and stairwell.

You can go northeast, northwest, south to the Veranda Walkway, east, west to Convergence Central, and down from here.

(From here, you can move to northeast, northwest, south, east, west, and down.)

>nw
Upper Tower Connector
The Upper Tower Connector - connection between the short and tall towers.

You can go southeast to the Floor Changer and southwest to Convergence Central from here.

(From here, you can move to southeast and southwest.)

>sw
Convergence Central
Convergence Central

You can go northeast to the Upper Tower Connector, south, southwest to the Dealer's Room, and east to the Floor Changer from here.

(From here, you can move to northeast, south, southwest, and east.)

>s
Mainstage
Mainstage

You can go north to Convergence Central from here.

(From here, you can move to north.)

>n
Convergence Central
Convergence Central

You can go northeast to the Upper Tower Connector, south to Mainstage, southwest to the Dealer's Room, and east to the Floor Changer from here.

(From here, you can move to northeast, south, southwest, and east.)

>e
Floor Changer
Elevators, escalators, and stairwell.

You can go northeast, northwest to the Upper Tower Connector, south to the Veranda Walkway, east, west to Convergence Central, and down from here.

(From here, you can move to northeast, northwest, south, east, west, and down.)

>e
Upper Northside Hallway
A hallway filled with freaks and nerds.

You can go south, southeast, southwest to the Veranda Walkway, and west to the Floor Changer from here.

(From here, you can move to south, southeast, southwest, and west.)

>s
Room 205
Room 205

You can go north to the Upper Northside Hallway from here.

(From here, you can move to north.)

>n
Upper Northside Hallway
A hallway filled with freaks and nerds.

You can go south to Room 205, southeast, southwest to the Veranda Walkway, and west to the Floor Changer from here.

(From here, you can move to south, southeast, southwest, and west.)

>sw
Veranda Walkway
Outside the Space Lounge you look out into the larger Raditree Building to see the pool under a high ceiling. Consuite lies beyond the pool in the main courtyard. Boffers beat each other up in the fenced in section of the courtyard. A floating dolphin surveillance pod floats by making you twitch instintively to make your shiny wig come between the camera and your face.

You can see an airlock, a black rod, and a floating dolphin (closed) here.

You can go north to the Floor Changer, northeast to the Upper Northside Hallway, northwest, southeast, west through the airlock to the Space Lounge, up, and down from here.

(From here, you can move to north, northeast, northwest, southeast, west, up, and down.)

>l rod
A three foot black rod with a rusty star on one end lies nearby.

>take rod
Taken.

>read note
Cast the secret spell xyzzy

>say xyzzy
you feel a whooshy sound enter your eyeball sockets and then your tummy flips over your groiny-place. WHOOOOOAAAA suddenly you find yourself trasported to the...

you feel a whooshy sound enter your eyeball sockets and then your tummy flips over your groiny-place. WHOOOOOAAAA suddenly you find yourself trasported to the...

Secret Room
You are in the Secret Room. DON'T TELL ANYONE YOU WERE EVER HERE! It's really dark, you can't see much.

You can see a dolphin code and a book here.

You can see no obvious exits.

(There are no routes out of this room.)

Under the influence of the black rod, you pronounced "xyzzy" as Xhi-zee. You understand now that the purpose of the black rod is to bring people here, to the Secret Room.

>l code
It is fish shaped, and vibrates - readout screen says "Status optimal".

>take code
Taken.

>l book
"yzxxy" is the title, and the contents just say "Your Future Lies in Space" over and over again.

>take book
Taken.

>say yzxxy
Space Lounge
You are in the Space Lounge. It's dim and glowy all over with pulsating colors and subtle hypnotic sounds.

You can see an airlock, a bar (on which are a Glowing Sphere and a glittery box (in which is a security readout)), a bench, a chair, a bartender, AFrame, and a Security bot here.

You can go east through the airlock to the Veranda Walkway and west from here.

(From here, you can move to east and west.)

Under the influence of the black rod, you pronounced "yzxxy" as Wizex-zi. You are glad there is some way out of that Secret Room!

I beg your pardon?

>l
Space Lounge
You are in the Space Lounge. It's dim and glowy all over with pulsating colors and subtle hypnotic sounds.

You can see an airlock, a bar (on which are a Glowing Sphere and a glittery box (in which is a security readout)), a bench, a chair, a bartender, AFrame, and a Security bot here.

You can go east through the airlock to the Veranda Walkway and west from here.

(From here, you can move to east and west.)

>e
Veranda Walkway
Outside the Space Lounge you look out into the larger Raditree Building to see the pool under a high ceiling. Consuite lies beyond the pool in the main courtyard. Boffers beat each other up in the fenced in section of the courtyard. A floating dolphin surveillance pod floats by making you twitch instintively to make your shiny wig come between the camera and your face.

You can see an airlock and a floating dolphin (closed) here.

You can go north to the Floor Changer, northeast to the Upper Northside Hallway, northwest, southeast, west through the airlock to the Space Lounge, up, and down from here.

(From here, you can move to north, northeast, northwest, southeast, west, up, and down.)

>use dophin code
I didn't understand that sentence.

>l dolphin
(the dolphin code)
It is fish shaped, and vibrates - readout screen says "Status optimal".

>open dolphin
(the dolphin code)
It isn't something you can open.

* * *

>open floating dolphin
(first unlocking the floating dolphin)
(with the dolphin code)
You open the floating dolphin.

>get in dolpin
You can't see any such thing.

>go floating dolphin
You have access to the floating dolphin. Wow - you'll be able to go up above the courtyard now and see everything!

Go up!

>up
Floating Courtyard (in the floating dolphin)
The floating dolphin is transparent, but tints everything outside very faintly lavender.

This is amazing - you are up above everything and can see so much up here! There's a pool down below, and a fenced in courtyard with some kind of security gate system surrounding it, and Consuite.

You can go down to the Veranda Walkway from here.

(From here, you can move to down.)

>down
Veranda Walkway (in the floating dolphin)
The floating dolphin is transparent, but tints everything outside very faintly lavender.

Outside the Space Lounge you look out into the larger Raditree Building to see the pool under a high ceiling. Consuite lies beyond the pool in the main courtyard. Boffers beat each other up in the fenced in section of the courtyard. A floating dolphin surveillance pod floats by making you twitch instintively to make your shiny wig come between the camera and your face.

You can see an airlock here.

You can go north to the Floor Changer, northeast to the Upper Northside Hallway, northwest, southeast, west through the airlock to the Space Lounge, up to the Floating Courtyard, and down from here.

(From here, you can move to north, northeast, northwest, southeast, west, up, and down.)

>go airlock
Space Lounge (in the floating dolphin)
The floating dolphin is transparent, but tints everything outside very faintly lavender.

You are in the Space Lounge. It's dim and glowy all over with pulsating colors and subtle hypnotic sounds.

You can see an airlock, a bar (on which are a Glowing Sphere and a glittery box (in which is a security readout)), a bench, a chair, a bartender, AFrame, and a Security bot here.

You can go east through the airlock to the Veranda Walkway and west from here.

(From here, you can move to east and west.)

>talk aframe
I didn't understand that sentence.

>l aframe
Aframe is looking pretty sharp there wearing a pin-striped suit with his usual aplomb.

(Health: 100)

>l bot
Looks like a standard security bot.

(Health: 100)

>shoot bot
(with the crazy looking gun)
You need a projectile weapon to shoot anything.

>shoot bot with gun
You need a projectile weapon to shoot anything.

>l
Space Lounge (in the floating dolphin)
The floating dolphin is transparent, but tints everything outside very faintly lavender.

You are in the Space Lounge. It's dim and glowy all over with pulsating colors and subtle hypnotic sounds.

You can see an airlock, a bar (on which are a Glowing Sphere and a glittery box (in which is a security readout)), a bench, a chair, a bartender, AFrame, and a Security bot here.

You can go east through the airlock to the Veranda Walkway and west from here.

(From here, you can move to east and west.)

>sit chair
I didn't understand that sentence.

>sit in chair
Oh boy this chair looks really soft and comfy! Ooooh ya you are totally gonna sit on this chair big time.

(getting out of the floating dolphin)
You get onto the chair.

"What a lovely soft and dreamy world", you think. Nothing is wrong and everything is right. Right and soft. Sooooo sooooofffft.

>get up
You'd rather be asleep. Whatever other thing you would do besides being in this nothing is a bad idea and not really that good of an option compared to being in this insanely comfy nothing.

"What a lovely soft and dreamy world", you think. Nothing is wrong and everything is right. Right and soft. Sooooo sooooofffft.

>get out of chair
I only understood you as far as wanting to get outside.

>get up
You'd rather be asleep. Whatever other thing you would do besides being in this nothing is a bad idea and not really that good of an option compared to being in this insanely comfy nothing.

"What a lovely soft and dreamy world", you think. Nothing is wrong and everything is right. Right and soft. Sooooo sooooofffft.

>get out
You'd rather be asleep. Whatever other thing you would do besides being in this nothing is a bad idea and not really that good of an option compared to being in this insanely comfy nothing.

"What a lovely soft and dreamy world", you think. Nothing is wrong and everything is right. Right and soft. Sooooo sooooofffft.

>stand up
You'd rather be asleep. Whatever other thing you would do besides being in this nothing is a bad idea and not really that good of an option compared to being in this insanely comfy nothing.

"What a lovely soft and dreamy world", you think. Nothing is wrong and everything is right. Right and soft. Sooooo sooooofffft.

>get off
You'd rather be asleep. Whatever other thing you would do besides being in this nothing is a bad idea and not really that good of an option compared to being in this insanely comfy nothing.

"What a lovely soft and dreamy world", you think. Nothing is wrong and everything is right. Right and soft. Sooooo sooooofffft.

>get off chair
You just can't get up, you are way too comfortable! Maybe if you just stayed here in this chair forever you would be better off than whatever else you were going to do. Does it really matter?

"What a lovely soft and dreamy world", you think. Nothing is wrong and everything is right. Right and soft. Sooooo sooooofffft.

* * *

>get off chair
Whew! You just barely escaped that chair, it's so comfy you could get stuck in it forever!

>l
Space Lounge
You are in the Space Lounge. It's dim and glowy all over with pulsating colors and subtle hypnotic sounds.

You can see an airlock, a floating dolphin (empty), a bar (on which are a Glowing Sphere and a glittery box (in which is a security readout)), a bench, a chair, a bartender, AFrame, and a Security bot here.

You can go east through the airlock to the Veranda Walkway and west from here.

(From here, you can move to east and west.)

>w
BehindtheBar
You shouldn't be here, it's behind the bar.

You can see ShinyUnicorn, RocketBlaster, anther, and thisas here.

You can go east to the Space Lounge from here.

(From here, you can move to east.)

>e
Space Lounge
You are in the Space Lounge. It's dim and glowy all over with pulsating colors and subtle hypnotic sounds.

You can see an airlock, a floating dolphin (empty), a bar (on which are a Glowing Sphere and a glittery box (in which is a security readout)), a bench, a chair, a bartender, AFrame, and a Security bot here.

You can go east through the airlock to the Veranda Walkway and west to the BehindtheBar from here.

(From here, you can move to east and west.)

>l bartender
The bartender is talking with a friend.

(Health: 100)

>l bartender
The bartender is standing there looking you over.

(Health: 100)

>l bartender
The bartender is talking with a friend.

(Health: 100)

>l bartender
The bartender is cleaning the blender.

(Health: 100)

>l bartender
The bartender is dancing.

(Health: 100)

>l bartender
The bartender is talking with a friend.

(Health: 100)

>l aframe
Aframe is looking pretty sharp there wearing a pin-striped suit with his usual aplomb.

(Health: 100)

>give bartender coin
She accepts with a smile and slides you a smoothie. It looks friggin delicious.

>drink smoothie
You can't see any such thing.

>inventory
You are carrying: 
thisas
a book
a dolphin code
a black rod
a bowl
a crazy looking gun
a black ninja outfit
ElectroMisdirector
a message receiver
a dagger
(Health: 100)

>l thisas
thisas

>drink thisas
You quaff thisas. It goes down beautifully.

Floating Courtyard
This is amazing - you are up above everything and can see so much up here! There's a pool down below, and a fenced in courtyard with some kind of security gate system surrounding it, and Consuite.

You can go down to the Veranda Walkway from here.

(From here, you can move to down.)

>d
Veranda Walkway
Outside the Space Lounge you look out into the larger Raditree Building to see the pool under a high ceiling. Consuite lies beyond the pool in the main courtyard. Boffers beat each other up in the fenced in section of the courtyard. A floating dolphin surveillance pod floats by making you twitch instintively to make your shiny wig come between the camera and your face.

You can see an airlock here.

You can go north to the Floor Changer, northeast to the Upper Northside Hallway, northwest, southeast, west through the airlock to the Space Lounge, up to the Floating Courtyard, and down from here.

(From here, you can move to north, northeast, northwest, southeast, west, up, and down.)

>airlock
I didn't understand that sentence.

>se
Upper Southside Hallway
This hallway is NUTS - there are signs everywhere and lights and sounds flashing. From this hallway you can get into a bunch of Party Rooms

You can go north, northeast, northwest to the Veranda Walkway, south, southeast, and southwest from here.

(From here, you can move to north, northeast, northwest, south, southeast, and southwest.)

* * *

>the matrix
Incorrect. Next question.

This film has annoying gothy villians but a super cool reveal that everyone was in a giant space habitat the WHOLE TIME?! (btw foreshadowing...)

Please enter your answer

I beg your pardon?

Please enter your answer

>don't know
Incorrect. Next question.

In which movie did the main character die from super disturbing eye bulging decompression after helmet face plate breakage in the opening scene then but it turned it was just a dream? (or was it a premonition? or was it an implanted memory?)

Please enter your answer

>i'm bad a trivia
Incorrect. Next question.

This movie has a sail boat smash into the end of a fake world. Everyone watching just goes totally nuts.

Please enter your answer

>trivia is dumb
That was Round One, now onto Round Two!

Round2
Now onto Round Two where the questions get slightly harder but are worth ten points a piece.

You can see no obvious exits.

(There are no routes out of this room.)

In the contract version of what card game are players identified by points on the compass?

Please enter your answer

>k
That was Round Two, now onto Round Three!

Round3
Round Three is here! The questions are harder but now worth fifteen points a piece.

You can see no obvious exits.

(There are no routes out of this room.)

The Original Ritz Hotel is located in what European City?

Please enter your answer

>paris
That was Round Three, now onto Round Four!

Round4
This is it, the final round. Europe's The Final Countdown is now playing on loop in your head and the questions are worth a whopping twenty points a piece.

You can see no obvious exits.

(There are no routes out of this room.)

Who wrote The Coming of the Quantam Cats?

Please enter your answer

>why would i ever read that
Incorrect. Next question.

Who wrote a series of stories about children travelling between parallel worlds with a powerful knife?

Please enter your answer

>Philip Pullman
Well done.  Next question.

What movie about parallel universes involves a good version of Jet Li trying to stop an evil version of Jet Li?

Please enter your answer

>The One
Well done.  Next question.

What is the name of the author who wrote about Sir Luther of Arkwright?

Please enter your answer

>no idea
Incorrect. That was the end of Round Four.

End
Final Score: 40/200

You can go northeast to the Upper Southside Hallway from here.

(From here, you can move to northeast.)

>i
You are carrying: 
a quizinator2
a book
a dolphin code
a black rod
a bowl
a crazy looking gun
a black ninja outfit
ElectroMisdirector
a message receiver
a dagger
(Health: 100)

[Your score has just gone up by forty points.]

>l quizinator2
You got this for bad quizinating.

* * *

>take gun
You can't see any such thing.

* * *

>take gun
You have no idea what this gun does. You've never seen anything like it! You're pretty stoked to get this gun.

Taken.

>shoot aframe with gun
This weird ray comes out of your gun but it's like it's moving in slow-motion...as the beam wiggles toward Aframe super duper slow he steps out of the way of it. The wiggling intensifies and disappears. Aframe is looking at you with this annoyed look. Like he doesn't totally trust you anymore because you just tried to twinkle him out of existence.

>aframe, remove suit
He says "uhm I am not going to help you out because in case you forgot you tried to kill me. I don't even know why"

* * *

>take ninja
(the black ninja costume)
Taken.

>wear ninja
(the black ninja costume)
You are a ninja!

>look
Space Lounge
You are in the Space Lounge, rumored to be the center of The Resistance. "Why did I come here?" you briefly wonder before looking around.

You can see an airlock, a bar (on which are a glittery box (closed) and a Glowing Sphere), a chair, a bench, and a bartender here.

You can go east through the airlock (closed) from here.

(From here, you can move to east.)

* * *

>wear ninja
(the black ninja costume)
You are a ninja!

>look self
As good-looking as ever.

>i
You're empty-handed. You're wearing a black ninja costume and a wig.

>look ninja costume
The black ninja costume is kind of unremarkable, not really exciting like some cool crazy gun would be or something.

The black ninja costume's pocket contains a throwing star and a smoke bomb.

* * *

>look self
As good-looking as ever.

>look
Space Lounge
You are in the Space Lounge, rumored to be the center of The Resistance. "Why did I come here?" you briefly wonder before looking around.

You can see an airlock, a bar (on which are a glittery box (closed) and a Glowing Sphere), a chair, a bench, and a bartender here.

You can go east through the airlock (closed) from here.

(From here, you can move to east.)

* * *

>look self
As good-looking as ever.

>look ninja costume
The black ninja costume is kind of unremarkable, not really exciting like some cool crazy gun would be or something.

The black ninja costume's pocket contains a throwing star and a smoke bomb.

>take throwing star
Taken.

>take smoke bomb
Taken.

>look throwing star
The throwing star is kind of unremarkable, not really exciting like some cool crazy gun would be or something.

* * *

>take ninja outfit
Taken.

>wear ninja outfit
You are a ninja! It feels like you could blend into the shadows, or maybe you ARE the shadows, this ninja outfit makes you feel super ninja-like

>examine ninja outfit
This is a ninja outfit, it's black and has a hood that covers your face. It has pockets in it to store cool ninja gear. It has these sweet built in booties that muffle your footsteps as if you were a total ninja, which you totally are if you are wearing this outfit. You could sneak around a place with shadows without being detected if you were wearing this thing. You'd be so ninja.

The pocket contains nothing.

* * *

>test
test? Interesting, nice.

Space Lounge
You are in the Space Lounge. It's dim and glowy all over with pulsating colors and subtle hypnotic sounds.

You can see an airlock, a black ninja outfit, a bar (on which are a Glowing Sphere and a glittery box (closed)), a bench, a comfy looking chair, a bartender, AFrame, and a securityBot here.

You can go east through the airlock (closed) and west from here.

>sit on chair
Oh boy this chair looks really soft and comfy! Ooooh ya you are totally gonna sit on this chair big time.

You get onto the comfy looking chair.

Sooooo comfy. So sooooo comfy. Mmmmm...

>look
Space Lounge (on the comfy looking chair)
You are in the Space Lounge. It's dim and glowy all over with pulsating colors and subtle hypnotic sounds.

You can see an airlock, a black ninja outfit, a bar (on which are a Glowing Sphere and a glittery box (closed)), a bench, a bartender, AFrame, and a securityBot here.

You can go east through the airlock (closed) and west from here.

Sooooo comfy. So sooooo comfy. Mmmmm...

>get off of chair
You can't see any such thing.

>get off chair
You just can't get up, you are way too comfortable! Maybe if you just stayed here in this comfy looking chair forever you would be better off than whatever else you were going to do. Does it really matter?

Oooh yes, this is a wonderful world. "What a luxuriously decadent and beautiful reality to be in" you think as you nestle further within the folds of the chair

>get off chair
You try to heave yourself up, but the soft lusciousness of the comfy looking chair envelopes you and pulls you back into its comfy folds. Oooooo...so comfy...so sooooooofffffft...

"What was I trying to do?" you think for a sec before you realize how comfy the chair you are in is. It's kind of incredible, you feel like you've accomlished enough in life.

* * *

>sit on chair
Oh boy this chair looks really soft and comfy! Ooooh ya you are totally gonna sit on this chair big time.

Don't you remember the last time you were in that comfy looking chair? It almost ATE YOU! What is your deal? Don't sit in this comfy looking chair, it's too dangerous! Only a master of mental projection could sit on this comfy looking chair without its super soft comfy-ness obliterating and subsuming your soul to its dark comfy desires.

>sit on chair
Oh boy this chair looks really soft and comfy! Ooooh ya you are totally gonna sit on this chair big time.

    *** You sit on the chair again and sink forever into its comfyness. You never rise again. ***

In that game you scored 0 out of a possible 0, in 8 turns.

Would you like to RESTART, RESTORE a saved game, QUIT, or UNDO the last command?

* * *

>testy mctesterson
Oh, testy mctesterson eh!? I've heard a you.

Space Lounge
You are in the Space Lounge. It's dim and glowy all over with pulsating colors and subtle hypnotic sounds.

You can see an airlock, a black ninja outfit, a bar (on which are a Glowing Sphere and a glittery box (closed)), a bench, a comfy looking chair, a bartender, AFrame, and a securityBot here.

You can go east through the airlock (closed) and west from here.

>securityBot, go west
The securityBot looks pissed. Maybe you outta not mess with securityBots...
1

>securityBot, go west
You pissed off the securityBot one too many times. The securityBot's large and small and micro arms unfurl like a lotus made of cobras.  It's central power unit glows briefly and precisely pulses a beam of pure energy all over your beautiful body and now you're dead

    *** The End ***

In that game you scored 0 out of a possible 0, in 2 turns.

Would you like to RESTART, RESTORE a saved game, QUIT, or UNDO the last command?

* * *

>wear ninja outfit
(first taking the black ninja outfit)
You are a ninja! It feels like you could blend into the shadows, or maybe you ARE the shadows, this ninja outfit makes you feel super ninja-like

>examine ninja outfit
This is a ninja outfit, it's black and has a hood that covers your face. It has pockets in it to store cool ninja gear. It has these sweet built in booties that muffle your footsteps as if you were a total ninja, which you totally are if you are wearing this outfit. You could sneak around a place with shadows without being detected if you were wearing this thing. You'd be so ninja.

The pocket contains nothing.

>examine ninja outfit
This is a ninja outfit, it's black and has a hood that covers your face. It has pockets in it to store cool ninja gear. It has these sweet built in booties that muffle your footsteps as if you were a total ninja, which you totally are if you are wearing this outfit. You could sneak around a place with shadows without being detected if you were wearing this thing. You'd be so ninja.

The pocket contains nothing.

* * *

>word 2
word 2!? Har har har! Musta been one-a them vat babies huh?

Space Lounge
You are in the Space Lounge. It's dim and glowy all over with pulsating colors and subtle hypnotic sounds.

You can see an airlock, a black ninja outfit, a bar (on which are a Glowing Sphere and a glittery box (closed)), a bench, a comfy looking chair, a bartender, AFrame, and a securityBot here.

You can go east through the airlock (closed) and west from here.

>look ninja
(the black ninja outfit)
This is a ninja outfit, it's black and has a hood that covers your face. It has a nice pocket in it to store cool ninja gear. It has these sweet built in booties that muffle your footsteps as if you were a total ninja, which you totally are if you are wearing this outfit. You could sneak around a place with shadows without being detected if you were wearing this thing. You'd be so ninja.

The black ninja outfit's pocket contains a throwing star and a smoke bomb.

* * *

>take ninja
(the black ninja outfit)
Taken.

>look sphere
OOOOoooo glowy-sphere thingie! Its purple soft glow makes you feel safe and secure. It looks like there's some sort of encased helix-key as a component to the glowy-ness.

>sit chair
I didn't understand that sentence.

>sit on chair
Oh boy this chair looks really soft and comfy! Ooooh ya you are totally gonna sit on this chair big time.

You get onto the comfy looking chair.

Oooh yes, this is a wonderful world. What a luxuriously decadent and beautiful reality to be in" you think as you nestle further within the folds of the chair

* * *

>xyzzx
That's not a verb I recognise.

>cast xyzzx
I didn't understand that sentence.

>xyzzy
You are unable to articulate the second "z" separately from the first, and the spell fails in a disdainful puff. If only you had the black rod.

>take rod
Taken.

* * *

>xyzzy
You are unable to articulate the second "z" separately from the first, and the spell fails in a disdainful puff. If only you had the black rod.

>open box
You open the glittery box, revealing a security readout, a bowl and a crazy looking gun.

* * *

>take rod
Taken.

>xyzzy
you feel a whooshy sound enter your eyeball sockets and then your tummy flips over your groiny-place. WHOOOOOAAAA suddenly you find yourself trasported to the...

you feel a whooshy sound enter your eyeball sockets and then your tummy flips over your groiny-place. WHOOOOOAAAA suddenly you find yourself trasported to the...

Secret Room
You are in the Secret Room. DON'T TELL ANYONE YOU WERE EVER HERE! It's really dark, you can't see much.

Under the influence of the black rod, you pronounced "xyzzy" as Xhi-zee. You understand now that the purpose of the black rod is to bring people here, to the Secret Room.

>yzxxy
Space Lounge
You are in the Space Lounge, rumored to be the center of The Resistance. "Why did I come here?" you briefly wonder before looking around.

You can see an airlock, a bar (on which is a glittery box (in which are a security readout and a bowl (in which is a note))), a soft chair, a skate ramp technology chair, Many soft chairs and a bartender here.

Under the influence of the black rod, you pronounced "yzxxy" as Wizex-zi. You are glad there is some way out of that Secret Room!